id, state, cur_score, action, reward, next_state, next_score
5,"[[0, 0, 0, 0], [0, 0, 0, 0], [0, 0, 0, 0], [2, 2, 0, 0]]",67688,left,4,"[[0, 0, 0, 4], [0, 0, 0, 0], [0, 0, 0, 0], [4, 0, 0, 0]]",67692
5,"[[0, 0, 0, 4], [0, 0, 0, 0], [0, 0, 0, 0], [4, 0, 0, 0]]",67692,right,0,"[[0, 0, 0, 4], [0, 0, 0, 0], [0, 0, 4, 0], [0, 0, 0, 4]]",67692
5,"[[0, 0, 0, 4], [0, 0, 0, 0], [0, 0, 4, 0], [0, 0, 0, 4]]",67692,down,8,"[[0, 0, 0, 0], [0, 0, 0, 0], [0, 0, 0, 0], [0, 4, 4, 8]]",67700
5,"[[0, 0, 0, 0], [0, 0, 0, 0], [0, 0, 0, 0], [0, 4, 4, 8]]",67700,right,8,"[[0, 4, 0, 0], [0, 0, 0, 0], [0, 0, 0, 0], [0, 0, 8, 8]]",67708
5,"[[0, 4, 0, 0], [0, 0, 0, 0], [0, 0, 0, 0], [0, 0, 8, 8]]",67708,left,16,"[[4, 0, 0, 0], [4, 0, 0, 0], [0, 0, 0, 0], [16, 0, 0, 0]]",67724
5,"[[4, 0, 0, 0], [4, 0, 0, 0], [0, 0, 0, 0], [16, 0, 0, 0]]",67724,up,8,"[[8, 0, 0, 0], [16, 2, 0, 0], [0, 0, 0, 0], [0, 0, 0, 0]]",67732
5,"[[8, 0, 0, 0], [16, 2, 0, 0], [0, 0, 0, 0], [0, 0, 0, 0]]",67732,left,0,"[[8, 0, 0, 0], [16, 2, 0, 2], [0, 0, 0, 0], [0, 0, 0, 0]]",67732
5,"[[8, 0, 0, 0], [16, 2, 0, 2], [0, 0, 0, 0], [0, 0, 0, 0]]",67732,left,4,"[[8, 0, 0, 4], [16, 4, 0, 0], [0, 0, 0, 0], [0, 0, 0, 0]]",67736
5,"[[8, 0, 0, 4], [16, 4, 0, 0], [0, 0, 0, 0], [0, 0, 0, 0]]",67736,up,0,"[[8, 4, 0, 4], [16, 0, 0, 4], [0, 0, 0, 0], [0, 0, 0, 0]]",67736
5,"[[8, 4, 0, 4], [16, 0, 0, 4], [0, 0, 0, 0], [0, 0, 0, 0]]",67736,left,8,"[[8, 8, 0, 0], [16, 4, 0, 0], [0, 0, 0, 0], [0, 0, 0, 2]]",67744
5,"[[8, 8, 0, 0], [16, 4, 0, 0], [0, 0, 0, 0], [0, 0, 0, 2]]",67744,left,16,"[[16, 0, 0, 0], [16, 4, 0, 0], [0, 0, 2, 0], [2, 0, 0, 0]]",67760
5,"[[16, 0, 0, 0], [16, 4, 0, 0], [0, 0, 2, 0], [2, 0, 0, 0]]",67760,up,32,"[[32, 4, 2, 0], [2, 0, 0, 0], [0, 4, 0, 0], [0, 0, 0, 0]]",67792
5,"[[32, 4, 2, 0], [2, 0, 0, 0], [0, 4, 0, 0], [0, 0, 0, 0]]",67792,up,8,"[[32, 8, 2, 0], [2, 0, 0, 0], [2, 0, 0, 0], [0, 0, 0, 0]]",67800
5,"[[32, 8, 2, 0], [2, 0, 0, 0], [2, 0, 0, 0], [0, 0, 0, 0]]",67800,up,4,"[[32, 8, 2, 0], [4, 0, 0, 0], [0, 0, 4, 0], [0, 0, 0, 0]]",67804
5,"[[32, 8, 2, 0], [4, 0, 0, 0], [0, 0, 4, 0], [0, 0, 0, 0]]",67804,left,0,"[[32, 8, 2, 0], [4, 0, 0, 0], [4, 4, 0, 0], [0, 0, 0, 0]]",67804
5,"[[32, 8, 2, 0], [4, 0, 0, 0], [4, 4, 0, 0], [0, 0, 0, 0]]",67804,up,8,"[[32, 8, 2, 0], [8, 4, 0, 0], [0, 0, 0, 0], [0, 0, 2, 0]]",67812
5,"[[32, 8, 2, 0], [8, 4, 0, 0], [0, 0, 0, 0], [0, 0, 2, 0]]",67812,down,4,"[[0, 0, 0, 0], [0, 0, 0, 4], [32, 8, 0, 0], [8, 4, 4, 0]]",67816
5,"[[0, 0, 0, 0], [0, 0, 0, 4], [32, 8, 0, 0], [8, 4, 4, 0]]",67816,right,8,"[[0, 0, 2, 0], [0, 0, 0, 4], [0, 0, 32, 8], [0, 0, 8, 8]]",67824
5,"[[0, 0, 2, 0], [0, 0, 0, 4], [0, 0, 32, 8], [0, 0, 8, 8]]",67824,left,16,"[[2, 0, 0, 0], [4, 4, 0, 0], [32, 8, 0, 0], [16, 0, 0, 0]]",67840
5,"[[2, 0, 0, 0], [4, 4, 0, 0], [32, 8, 0, 0], [16, 0, 0, 0]]",67840,right,8,"[[0, 0, 0, 2], [0, 4, 0, 8], [0, 0, 32, 8], [0, 0, 0, 16]]",67848
5,"[[0, 0, 0, 2], [0, 4, 0, 8], [0, 0, 32, 8], [0, 0, 0, 16]]",67848,up,16,"[[0, 4, 32, 2], [0, 0, 2, 16], [0, 0, 0, 16], [0, 0, 0, 0]]",67864
5,"[[0, 4, 32, 2], [0, 0, 2, 16], [0, 0, 0, 16], [0, 0, 0, 0]]",67864,up,32,"[[0, 4, 32, 2], [0, 0, 2, 32], [0, 0, 0, 0], [0, 0, 0, 4]]",67896
5,"[[0, 4, 32, 2], [0, 0, 2, 32], [0, 0, 0, 0], [0, 0, 0, 4]]",67896,left,0,"[[4, 32, 2, 0], [2, 32, 0, 0], [2, 0, 0, 0], [4, 0, 0, 0]]",67896
5,"[[4, 32, 2, 0], [2, 32, 0, 0], [2, 0, 0, 0], [4, 0, 0, 0]]",67896,up,68,"[[4, 64, 2, 0], [4, 0, 0, 0], [4, 4, 0, 0], [0, 0, 0, 0]]",67964
5,"[[4, 64, 2, 0], [4, 0, 0, 0], [4, 4, 0, 0], [0, 0, 0, 0]]",67964,left,8,"[[4, 64, 2, 0], [4, 0, 4, 0], [8, 0, 0, 0], [0, 0, 0, 0]]",67972
5,"[[4, 64, 2, 0], [4, 0, 4, 0], [8, 0, 0, 0], [0, 0, 0, 0]]",67972,up,8,"[[8, 64, 2, 0], [8, 0, 4, 0], [0, 0, 0, 0], [4, 0, 0, 0]]",67980
5,"[[8, 64, 2, 0], [8, 0, 4, 0], [0, 0, 0, 0], [4, 0, 0, 0]]",67980,up,16,"[[16, 64, 2, 0], [4, 0, 4, 0], [0, 0, 0, 4], [0, 0, 0, 0]]",67996
5,"[[16, 64, 2, 0], [4, 0, 4, 0], [0, 0, 0, 4], [0, 0, 0, 0]]",67996,left,8,"[[16, 64, 2, 0], [8, 0, 0, 0], [4, 0, 4, 0], [0, 0, 0, 0]]",68004
5,"[[16, 64, 2, 0], [8, 0, 0, 0], [4, 0, 4, 0], [0, 0, 0, 0]]",68004,left,8,"[[16, 64, 2, 0], [8, 0, 0, 0], [8, 2, 0, 0], [0, 0, 0, 0]]",68012
5,"[[16, 64, 2, 0], [8, 0, 0, 0], [8, 2, 0, 0], [0, 0, 0, 0]]",68012,down,16,"[[0, 0, 0, 0], [0, 0, 4, 0], [16, 64, 0, 0], [16, 2, 2, 0]]",68028
5,"[[0, 0, 0, 0], [0, 0, 4, 0], [16, 64, 0, 0], [16, 2, 2, 0]]",68028,up,32,"[[32, 64, 4, 2], [0, 2, 2, 0], [0, 0, 0, 0], [0, 0, 0, 0]]",68060
5,"[[32, 64, 4, 2], [0, 2, 2, 0], [0, 0, 0, 0], [0, 0, 0, 0]]",68060,left,4,"[[32, 64, 4, 2], [4, 4, 0, 0], [0, 0, 0, 0], [0, 0, 0, 0]]",68064
5,"[[32, 64, 4, 2], [4, 4, 0, 0], [0, 0, 0, 0], [0, 0, 0, 0]]",68064,right,8,"[[32, 64, 4, 2], [0, 0, 0, 8], [0, 2, 0, 0], [0, 0, 0, 0]]",68072
5,"[[32, 64, 4, 2], [0, 0, 0, 8], [0, 2, 0, 0], [0, 0, 0, 0]]",68072,left,0,"[[32, 64, 4, 2], [8, 4, 0, 0], [2, 0, 0, 0], [0, 0, 0, 0]]",68072
5,"[[32, 64, 4, 2], [8, 4, 0, 0], [2, 0, 0, 0], [0, 0, 0, 0]]",68072,down,0,"[[0, 0, 0, 0], [32, 0, 0, 0], [8, 64, 4, 0], [2, 4, 4, 2]]",68072
5,"[[0, 0, 0, 0], [32, 0, 0, 0], [8, 64, 4, 0], [2, 4, 4, 2]]",68072,up,8,"[[32, 64, 8, 2], [8, 4, 0, 0], [2, 0, 0, 0], [0, 4, 0, 0]]",68080
5,"[[32, 64, 8, 2], [8, 4, 0, 0], [2, 0, 0, 0], [0, 4, 0, 0]]",68080,up,8,"[[32, 64, 8, 2], [8, 8, 2, 0], [2, 0, 0, 0], [0, 0, 0, 0]]",68088
5,"[[32, 64, 8, 2], [8, 8, 2, 0], [2, 0, 0, 0], [0, 0, 0, 0]]",68088,left,16,"[[32, 64, 8, 2], [16, 2, 0, 0], [2, 0, 0, 0], [0, 0, 0, 4]]",68104
5,"[[32, 64, 8, 2], [16, 2, 0, 0], [2, 0, 0, 0], [0, 0, 0, 4]]",68104,up,0,"[[32, 64, 8, 2], [16, 2, 0, 4], [2, 0, 0, 0], [0, 0, 2, 0]]",68104
5,"[[32, 64, 8, 2], [16, 2, 0, 4], [2, 0, 0, 0], [0, 0, 2, 0]]",68104,left,0,"[[32, 64, 8, 2], [16, 2, 4, 0], [2, 0, 0, 0], [2, 0, 0, 4]]",68104
5,"[[32, 64, 8, 2], [16, 2, 4, 0], [2, 0, 0, 0], [2, 0, 0, 4]]",68104,up,4,"[[32, 64, 8, 2], [16, 2, 4, 4], [4, 0, 0, 0], [4, 0, 0, 0]]",68108
5,"[[32, 64, 8, 2], [16, 2, 4, 4], [4, 0, 0, 0], [4, 0, 0, 0]]",68108,left,8,"[[32, 64, 8, 2], [16, 2, 8, 0], [4, 0, 0, 0], [4, 0, 0, 4]]",68116
5,"[[32, 64, 8, 2], [16, 2, 8, 0], [4, 0, 0, 0], [4, 0, 0, 4]]",68116,up,24,"[[32, 64, 16, 2], [16, 2, 2, 4], [8, 0, 0, 0], [0, 0, 0, 0]]",68140
5,"[[32, 64, 16, 2], [16, 2, 2, 4], [8, 0, 0, 0], [0, 0, 0, 0]]",68140,right,4,"[[32, 64, 16, 2], [0, 16, 4, 4], [0, 4, 0, 8], [0, 0, 0, 0]]",68144
5,"[[32, 64, 16, 2], [0, 16, 4, 4], [0, 4, 0, 8], [0, 0, 0, 0]]",68144,down,0,"[[0, 0, 0, 0], [0, 64, 2, 2], [0, 16, 16, 4], [32, 4, 4, 8]]",68144
5,"[[0, 0, 0, 0], [0, 64, 2, 2], [0, 16, 16, 4], [32, 4, 4, 8]]",68144,left,44,"[[0, 0, 0, 0], [64, 4, 0, 0], [32, 4, 2, 0], [32, 8, 8, 0]]",68188
5,"[[0, 0, 0, 0], [64, 4, 0, 0], [32, 4, 2, 0], [32, 8, 8, 0]]",68188,up,72,"[[64, 8, 2, 0], [64, 8, 8, 0], [0, 0, 0, 0], [0, 0, 0, 4]]",68260
5,"[[64, 8, 2, 0], [64, 8, 8, 0], [0, 0, 0, 0], [0, 0, 0, 4]]",68260,down,144,"[[0, 0, 0, 0], [0, 0, 0, 0], [4, 0, 2, 0], [128, 16, 8, 4]]",68404
5,"[[0, 0, 0, 0], [0, 0, 0, 0], [4, 0, 2, 0], [128, 16, 8, 4]]",68404,left,0,"[[0, 0, 0, 0], [0, 4, 0, 0], [4, 2, 0, 0], [128, 16, 8, 4]]",68404
5,"[[0, 0, 0, 0], [0, 4, 0, 0], [4, 2, 0, 0], [128, 16, 8, 4]]",68404,up,0,"[[4, 4, 8, 4], [128, 2, 0, 0], [0, 16, 0, 0], [2, 0, 0, 0]]",68404
5,"[[4, 4, 8, 4], [128, 2, 0, 0], [0, 16, 0, 0], [2, 0, 0, 0]]",68404,left,8,"[[8, 8, 4, 0], [128, 2, 0, 4], [16, 0, 0, 0], [2, 0, 0, 0]]",68412
5,"[[8, 8, 4, 0], [128, 2, 0, 4], [16, 0, 0, 0], [2, 0, 0, 0]]",68412,right,16,"[[0, 0, 16, 4], [0, 128, 2, 4], [0, 0, 0, 16], [0, 2, 0, 2]]",68428
5,"[[0, 0, 16, 4], [0, 128, 2, 4], [0, 0, 0, 16], [0, 2, 0, 2]]",68428,down,8,"[[0, 2, 0, 0], [0, 0, 0, 8], [0, 128, 16, 16], [0, 2, 2, 2]]",68436
5,"[[0, 2, 0, 0], [0, 0, 0, 8], [0, 128, 16, 16], [0, 2, 2, 2]]",68436,left,36,"[[2, 0, 0, 0], [8, 0, 0, 0], [128, 32, 0, 0], [4, 2, 4, 0]]",68472
5,"[[2, 0, 0, 0], [8, 0, 0, 0], [128, 32, 0, 0], [4, 2, 4, 0]]",68472,up,0,"[[2, 32, 4, 0], [8, 2, 0, 0], [128, 0, 0, 0], [4, 4, 0, 0]]",68472
5,"[[2, 32, 4, 0], [8, 2, 0, 0], [128, 0, 0, 0], [4, 4, 0, 0]]",68472,right,8,"[[0, 2, 32, 4], [0, 2, 8, 2], [0, 0, 0, 128], [0, 0, 0, 8]]",68480
5,"[[0, 2, 32, 4], [0, 2, 8, 2], [0, 0, 0, 128], [0, 0, 0, 8]]",68480,down,4,"[[4, 0, 0, 4], [0, 0, 0, 2], [0, 0, 32, 128], [0, 4, 8, 8]]",68484
5,"[[4, 0, 0, 4], [0, 0, 0, 2], [0, 0, 32, 128], [0, 4, 8, 8]]",68484,right,24,"[[0, 0, 0, 8], [0, 0, 0, 2], [0, 2, 32, 128], [0, 0, 4, 16]]",68508
5,"[[0, 0, 0, 8], [0, 0, 0, 2], [0, 2, 32, 128], [0, 0, 4, 16]]",68508,left,0,"[[8, 0, 0, 0], [2, 0, 0, 0], [2, 32, 128, 2], [4, 16, 0, 0]]",68508
5,"[[8, 0, 0, 0], [2, 0, 0, 0], [2, 32, 128, 2], [4, 16, 0, 0]]",68508,up,4,"[[8, 32, 128, 2], [4, 16, 0, 0], [4, 0, 0, 0], [0, 2, 0, 0]]",68512
5,"[[8, 32, 128, 2], [4, 16, 0, 0], [4, 0, 0, 0], [0, 2, 0, 0]]",68512,up,8,"[[8, 32, 128, 2], [8, 16, 0, 0], [0, 2, 0, 0], [4, 0, 0, 0]]",68520
5,"[[8, 32, 128, 2], [8, 16, 0, 0], [0, 2, 0, 0], [4, 0, 0, 0]]",68520,down,16,"[[0, 0, 0, 0], [0, 32, 0, 2], [16, 16, 0, 0], [4, 2, 128, 2]]",68536
5,"[[0, 0, 0, 0], [0, 32, 0, 2], [16, 16, 0, 0], [4, 2, 128, 2]]",68536,left,32,"[[2, 0, 0, 0], [32, 2, 0, 0], [32, 0, 0, 0], [4, 2, 128, 2]]",68568
5,"[[2, 0, 0, 0], [32, 2, 0, 0], [32, 0, 0, 0], [4, 2, 128, 2]]",68568,down,68,"[[0, 0, 2, 0], [2, 0, 0, 0], [64, 0, 0, 0], [4, 4, 128, 2]]",68636
5,"[[0, 0, 2, 0], [2, 0, 0, 0], [64, 0, 0, 0], [4, 4, 128, 2]]",68636,right,8,"[[0, 0, 0, 2], [0, 0, 0, 2], [0, 4, 0, 64], [0, 8, 128, 2]]",68644
5,"[[0, 0, 0, 2], [0, 0, 0, 2], [0, 4, 0, 64], [0, 8, 128, 2]]",68644,left,0,"[[2, 0, 0, 4], [2, 0, 0, 0], [4, 64, 0, 0], [8, 128, 2, 0]]",68644
5,"[[2, 0, 0, 4], [2, 0, 0, 0], [4, 64, 0, 0], [8, 128, 2, 0]]",68644,up,4,"[[4, 64, 2, 4], [4, 128, 0, 0], [8, 0, 0, 0], [2, 0, 0, 0]]",68648
5,"[[4, 64, 2, 4], [4, 128, 0, 0], [8, 0, 0, 0], [2, 0, 0, 0]]",68648,down,8,"[[0, 0, 0, 0], [8, 0, 4, 0], [8, 64, 0, 0], [2, 128, 2, 4]]",68656
5,"[[0, 0, 0, 0], [8, 0, 4, 0], [8, 64, 0, 0], [2, 128, 2, 4]]",68656,up,16,"[[16, 64, 4, 4], [2, 128, 2, 0], [0, 0, 0, 2], [0, 0, 0, 0]]",68672
5,"[[16, 64, 4, 4], [2, 128, 2, 0], [0, 0, 0, 2], [0, 0, 0, 0]]",68672,left,8,"[[16, 64, 8, 0], [2, 128, 2, 0], [2, 0, 0, 0], [0, 2, 0, 0]]",68680
5,"[[16, 64, 8, 0], [2, 128, 2, 0], [2, 0, 0, 0], [0, 2, 0, 0]]",68680,down,4,"[[0, 0, 0, 0], [0, 64, 0, 0], [16, 128, 8, 2], [4, 2, 2, 0]]",68684
5,"[[0, 0, 0, 0], [0, 64, 0, 0], [16, 128, 8, 2], [4, 2, 2, 0]]",68684,left,4,"[[0, 0, 0, 0], [64, 2, 0, 0], [16, 128, 8, 2], [4, 4, 0, 0]]",68688
5,"[[0, 0, 0, 0], [64, 2, 0, 0], [16, 128, 8, 2], [4, 4, 0, 0]]",68688,right,8,"[[0, 0, 0, 0], [2, 0, 64, 2], [16, 128, 8, 2], [0, 0, 0, 8]]",68696
5,"[[0, 0, 0, 0], [2, 0, 64, 2], [16, 128, 8, 2], [0, 0, 0, 8]]",68696,up,4,"[[2, 128, 64, 4], [16, 0, 8, 8], [0, 0, 2, 0], [0, 0, 0, 0]]",68700
5,"[[2, 128, 64, 4], [16, 0, 8, 8], [0, 0, 2, 0], [0, 0, 0, 0]]",68700,left,16,"[[2, 128, 64, 4], [16, 16, 0, 0], [2, 0, 0, 0], [0, 4, 0, 0]]",68716
5,"[[2, 128, 64, 4], [16, 16, 0, 0], [2, 0, 0, 0], [0, 4, 0, 0]]",68716,left,32,"[[2, 128, 64, 4], [32, 0, 0, 0], [2, 0, 0, 0], [4, 4, 0, 0]]",68748
5,"[[2, 128, 64, 4], [32, 0, 0, 0], [2, 0, 0, 0], [4, 4, 0, 0]]",68748,left,8,"[[2, 128, 64, 4], [32, 0, 2, 0], [2, 0, 0, 0], [8, 0, 0, 0]]",68756
5,"[[2, 128, 64, 4], [32, 0, 2, 0], [2, 0, 0, 0], [8, 0, 0, 0]]",68756,right,0,"[[2, 128, 64, 4], [4, 0, 32, 2], [0, 0, 0, 2], [0, 0, 0, 8]]",68756
5,"[[2, 128, 64, 4], [4, 0, 32, 2], [0, 0, 0, 2], [0, 0, 0, 8]]",68756,down,4,"[[0, 4, 0, 0], [0, 0, 0, 4], [2, 0, 64, 4], [4, 128, 32, 8]]",68760
5,"[[0, 4, 0, 0], [0, 0, 0, 4], [2, 0, 64, 4], [4, 128, 32, 8]]",68760,up,8,"[[2, 4, 64, 8], [4, 128, 32, 8], [0, 2, 0, 0], [0, 0, 0, 0]]",68768
5,"[[2, 4, 64, 8], [4, 128, 32, 8], [0, 2, 0, 0], [0, 0, 0, 0]]",68768,down,16,"[[0, 2, 0, 0], [0, 4, 0, 0], [2, 128, 64, 0], [4, 2, 32, 16]]",68784
5,"[[0, 2, 0, 0], [0, 4, 0, 0], [2, 128, 64, 0], [4, 2, 32, 16]]",68784,up,0,"[[2, 2, 64, 16], [4, 4, 32, 0], [0, 128, 0, 0], [2, 2, 0, 0]]",68784
5,"[[2, 2, 64, 16], [4, 4, 32, 0], [0, 128, 0, 0], [2, 2, 0, 0]]",68784,right,16,"[[0, 4, 64, 16], [0, 2, 8, 32], [0, 0, 0, 128], [0, 0, 0, 4]]",68800
5,"[[0, 4, 64, 16], [0, 2, 8, 32], [0, 0, 0, 128], [0, 0, 0, 4]]",68800,up,0,"[[0, 4, 64, 16], [0, 2, 8, 32], [0, 0, 0, 128], [4, 0, 0, 4]]",68800
5,"[[0, 4, 64, 16], [0, 2, 8, 32], [0, 0, 0, 128], [4, 0, 0, 4]]",68800,right,8,"[[0, 4, 64, 16], [0, 2, 8, 32], [0, 0, 2, 128], [0, 0, 0, 8]]",68808
5,"[[0, 4, 64, 16], [0, 2, 8, 32], [0, 0, 2, 128], [0, 0, 0, 8]]",68808,left,0,"[[4, 64, 16, 0], [2, 8, 32, 0], [2, 128, 0, 2], [8, 0, 0, 0]]",68808
5,"[[4, 64, 16, 0], [2, 8, 32, 0], [2, 128, 0, 2], [8, 0, 0, 0]]",68808,up,4,"[[4, 64, 16, 2], [4, 8, 32, 0], [8, 128, 2, 0], [0, 0, 0, 0]]",68812
5,"[[4, 64, 16, 2], [4, 8, 32, 0], [8, 128, 2, 0], [0, 0, 0, 0]]",68812,up,8,"[[8, 64, 16, 2], [8, 8, 32, 0], [0, 128, 2, 0], [0, 0, 0, 4]]",68820
5,"[[8, 64, 16, 2], [8, 8, 32, 0], [0, 128, 2, 0], [0, 0, 0, 4]]",68820,right,16,"[[8, 64, 16, 2], [0, 0, 16, 32], [0, 0, 128, 2], [4, 0, 0, 4]]",68836
5,"[[8, 64, 16, 2], [0, 0, 16, 32], [0, 0, 128, 2], [4, 0, 0, 4]]",68836,up,32,"[[8, 64, 32, 2], [4, 0, 128, 32], [0, 0, 0, 2], [0, 0, 4, 4]]",68868
5,"[[8, 64, 32, 2], [4, 0, 128, 32], [0, 0, 0, 2], [0, 0, 4, 4]]",68868,left,8,"[[8, 64, 32, 2], [4, 128, 32, 0], [2, 0, 4, 0], [8, 0, 0, 0]]",68876
5,"[[8, 64, 32, 2], [4, 128, 32, 0], [2, 0, 4, 0], [8, 0, 0, 0]]",68876,up,64,"[[8, 64, 64, 2], [4, 128, 4, 0], [2, 0, 0, 0], [8, 0, 0, 2]]",68940
5,"[[8, 64, 64, 2], [4, 128, 4, 0], [2, 0, 0, 0], [8, 0, 0, 2]]",68940,right,128,"[[0, 8, 128, 2], [0, 4, 128, 4], [0, 0, 0, 2], [0, 4, 8, 2]]",69068
5,"[[0, 8, 128, 2], [0, 4, 128, 4], [0, 0, 0, 2], [0, 4, 8, 2]]",69068,down,268,"[[4, 0, 0, 0], [0, 0, 0, 2], [0, 8, 256, 4], [0, 8, 8, 4]]",69336
5,"[[4, 0, 0, 0], [0, 0, 0, 2], [0, 8, 256, 4], [0, 8, 8, 4]]",69336,down,24,"[[0, 0, 0, 0], [0, 0, 4, 0], [0, 0, 256, 2], [4, 16, 8, 8]]",69360
5,"[[0, 0, 0, 0], [0, 0, 4, 0], [0, 0, 256, 2], [4, 16, 8, 8]]",69360,left,16,"[[0, 0, 0, 0], [4, 0, 0, 0], [256, 2, 0, 4], [4, 16, 16, 0]]",69376
5,"[[0, 0, 0, 0], [4, 0, 0, 0], [256, 2, 0, 4], [4, 16, 16, 0]]",69376,right,32,"[[2, 0, 0, 0], [0, 0, 0, 4], [0, 256, 2, 4], [0, 0, 4, 32]]",69408
5,"[[2, 0, 0, 0], [0, 0, 0, 4], [0, 256, 2, 4], [0, 0, 4, 32]]",69408,down,8,"[[0, 2, 0, 0], [0, 0, 0, 0], [0, 0, 2, 8], [2, 256, 4, 32]]",69416
5,"[[0, 2, 0, 0], [0, 0, 0, 0], [0, 0, 2, 8], [2, 256, 4, 32]]",69416,left,0,"[[2, 0, 0, 0], [0, 0, 0, 0], [2, 8, 4, 0], [2, 256, 4, 32]]",69416
5,"[[2, 0, 0, 0], [0, 0, 0, 0], [2, 8, 4, 0], [2, 256, 4, 32]]",69416,up,12,"[[4, 8, 8, 32], [2, 256, 0, 0], [0, 0, 2, 0], [0, 0, 0, 0]]",69428
5,"[[4, 8, 8, 32], [2, 256, 0, 0], [0, 0, 2, 0], [0, 0, 0, 0]]",69428,left,16,"[[4, 16, 32, 0], [2, 256, 0, 0], [2, 2, 0, 0], [0, 0, 0, 0]]",69444
5,"[[4, 16, 32, 0], [2, 256, 0, 0], [2, 2, 0, 0], [0, 0, 0, 0]]",69444,up,4,"[[4, 16, 32, 0], [4, 256, 0, 0], [0, 2, 4, 0], [0, 0, 0, 0]]",69448
5,"[[4, 16, 32, 0], [4, 256, 0, 0], [0, 2, 4, 0], [0, 0, 0, 0]]",69448,up,8,"[[8, 16, 32, 0], [0, 256, 4, 0], [0, 2, 0, 0], [0, 0, 0, 2]]",69456
5,"[[8, 16, 32, 0], [0, 256, 4, 0], [0, 2, 0, 0], [0, 0, 0, 2]]",69456,right,0,"[[4, 8, 16, 32], [0, 0, 256, 4], [0, 0, 0, 2], [0, 0, 0, 2]]",69456
5,"[[4, 8, 16, 32], [0, 0, 256, 4], [0, 0, 0, 2], [0, 0, 0, 2]]",69456,up,4,"[[4, 8, 16, 32], [0, 0, 256, 4], [0, 0, 0, 4], [0, 0, 4, 0]]",69460
5,"[[4, 8, 16, 32], [0, 0, 256, 4], [0, 0, 0, 4], [0, 0, 4, 0]]",69460,up,8,"[[4, 8, 16, 32], [0, 0, 256, 8], [0, 0, 4, 0], [0, 2, 0, 0]]",69468
5,"[[4, 8, 16, 32], [0, 0, 256, 8], [0, 0, 4, 0], [0, 2, 0, 0]]",69468,left,0,"[[4, 8, 16, 32], [256, 8, 0, 0], [4, 0, 0, 0], [2, 2, 0, 0]]",69468
5,"[[4, 8, 16, 32], [256, 8, 0, 0], [4, 0, 0, 0], [2, 2, 0, 0]]",69468,up,16,"[[4, 16, 16, 32], [256, 2, 0, 0], [4, 2, 0, 0], [2, 0, 0, 0]]",69484
5,"[[4, 16, 16, 32], [256, 2, 0, 0], [4, 2, 0, 0], [2, 0, 0, 0]]",69484,right,32,"[[0, 4, 32, 32], [0, 0, 256, 2], [4, 0, 4, 2], [0, 0, 0, 2]]",69516
5,"[[0, 4, 32, 32], [0, 0, 256, 2], [4, 0, 4, 2], [0, 0, 0, 2]]",69516,left,72,"[[4, 64, 0, 4], [256, 2, 0, 0], [8, 2, 0, 0], [2, 0, 0, 0]]",69588
5,"[[4, 64, 0, 4], [256, 2, 0, 0], [8, 2, 0, 0], [2, 0, 0, 0]]",69588,down,4,"[[4, 0, 0, 0], [256, 0, 2, 0], [8, 64, 0, 0], [2, 4, 0, 4]]",69592
5,"[[4, 0, 0, 0], [256, 0, 2, 0], [8, 64, 0, 0], [2, 4, 0, 4]]",69592,left,8,"[[4, 0, 0, 0], [256, 2, 0, 4], [8, 64, 0, 0], [2, 8, 0, 0]]",69600
5,"[[4, 0, 0, 0], [256, 2, 0, 4], [8, 64, 0, 0], [2, 8, 0, 0]]",69600,up,0,"[[4, 2, 0, 4], [256, 64, 0, 0], [8, 8, 0, 2], [2, 0, 0, 0]]",69600
5,"[[4, 2, 0, 4], [256, 64, 0, 0], [8, 8, 0, 2], [2, 0, 0, 0]]",69600,right,16,"[[0, 4, 2, 4], [4, 0, 256, 64], [0, 0, 16, 2], [0, 0, 0, 2]]",69616
5,"[[0, 4, 2, 4], [4, 0, 256, 64], [0, 0, 16, 2], [0, 0, 0, 2]]",69616,down,4,"[[0, 0, 0, 0], [4, 0, 2, 4], [0, 0, 256, 64], [4, 4, 16, 4]]",69620
5,"[[0, 0, 0, 0], [4, 0, 2, 4], [0, 0, 256, 64], [4, 4, 16, 4]]",69620,down,8,"[[0, 0, 0, 0], [0, 0, 2, 4], [2, 0, 256, 64], [8, 4, 16, 4]]",69628
5,"[[0, 0, 0, 0], [0, 0, 2, 4], [2, 0, 256, 64], [8, 4, 16, 4]]",69628,right,0,"[[0, 0, 0, 0], [0, 2, 2, 4], [0, 2, 256, 64], [8, 4, 16, 4]]",69628
5,"[[0, 0, 0, 0], [0, 2, 2, 4], [0, 2, 256, 64], [8, 4, 16, 4]]",69628,down,4,"[[2, 0, 0, 0], [0, 0, 2, 4], [0, 4, 256, 64], [8, 4, 16, 4]]",69632
5,"[[2, 0, 0, 0], [0, 0, 2, 4], [0, 4, 256, 64], [8, 4, 16, 4]]",69632,down,8,"[[0, 2, 0, 0], [0, 0, 2, 4], [2, 0, 256, 64], [8, 8, 16, 4]]",69640
5,"[[0, 2, 0, 0], [0, 0, 2, 4], [2, 0, 256, 64], [8, 8, 16, 4]]",69640,left,16,"[[2, 0, 0, 0], [2, 4, 0, 4], [2, 256, 64, 0], [16, 16, 4, 0]]",69656
5,"[[2, 0, 0, 0], [2, 4, 0, 4], [2, 256, 64, 0], [16, 16, 4, 0]]",69656,right,40,"[[0, 0, 0, 2], [0, 4, 2, 8], [0, 2, 256, 64], [0, 0, 32, 4]]",69696
5,"[[0, 0, 0, 2], [0, 4, 2, 8], [0, 2, 256, 64], [0, 0, 32, 4]]",69696,up,0,"[[0, 4, 2, 2], [0, 2, 256, 8], [0, 2, 32, 64], [0, 0, 0, 4]]",69696
5,"[[0, 4, 2, 2], [0, 2, 256, 8], [0, 2, 32, 64], [0, 0, 0, 4]]",69696,left,4,"[[4, 4, 0, 0], [2, 256, 8, 0], [2, 32, 64, 0], [4, 0, 2, 0]]",69700
5,"[[4, 4, 0, 0], [2, 256, 8, 0], [2, 32, 64, 0], [4, 0, 2, 0]]",69700,right,8,"[[0, 2, 0, 8], [0, 2, 256, 8], [0, 2, 32, 64], [0, 0, 4, 2]]",69708
5,"[[0, 2, 0, 8], [0, 2, 256, 8], [0, 2, 32, 64], [0, 0, 4, 2]]",69708,down,20,"[[0, 0, 0, 2], [0, 0, 256, 16], [0, 2, 32, 64], [0, 4, 4, 2]]",69728
5,"[[0, 0, 0, 2], [0, 0, 256, 16], [0, 2, 32, 64], [0, 4, 4, 2]]",69728,left,8,"[[2, 0, 4, 0], [256, 16, 0, 0], [2, 32, 64, 0], [8, 2, 0, 0]]",69736
5,"[[2, 0, 4, 0], [256, 16, 0, 0], [2, 32, 64, 0], [8, 2, 0, 0]]",69736,up,0,"[[2, 16, 4, 0], [256, 32, 64, 0], [2, 2, 0, 0], [8, 0, 4, 0]]",69736
5,"[[2, 16, 4, 0], [256, 32, 64, 0], [2, 2, 0, 0], [8, 0, 4, 0]]",69736,right,4,"[[0, 2, 16, 4], [0, 256, 32, 64], [0, 0, 2, 4], [0, 0, 8, 4]]",69740
5,"[[0, 2, 16, 4], [0, 256, 32, 64], [0, 0, 2, 4], [0, 0, 8, 4]]",69740,down,8,"[[0, 0, 16, 0], [0, 0, 32, 4], [0, 2, 2, 64], [4, 256, 8, 8]]",69748
5,"[[0, 0, 16, 0], [0, 0, 32, 4], [0, 2, 2, 64], [4, 256, 8, 8]]",69748,right,20,"[[0, 0, 0, 16], [0, 0, 32, 4], [0, 4, 4, 64], [0, 4, 256, 16]]",69768
5,"[[0, 0, 0, 16], [0, 0, 32, 4], [0, 4, 4, 64], [0, 4, 256, 16]]",69768,up,8,"[[0, 8, 32, 16], [0, 0, 4, 4], [2, 0, 256, 64], [0, 0, 0, 16]]",69776
5,"[[0, 8, 32, 16], [0, 0, 4, 4], [2, 0, 256, 64], [0, 0, 0, 16]]",69776,left,8,"[[8, 32, 16, 0], [8, 0, 0, 0], [2, 256, 64, 0], [16, 0, 0, 4]]",69784
5,"[[8, 32, 16, 0], [8, 0, 0, 0], [2, 256, 64, 0], [16, 0, 0, 4]]",69784,down,16,"[[2, 0, 0, 0], [16, 0, 0, 0], [2, 32, 16, 0], [16, 256, 64, 4]]",69800
5,"[[2, 0, 0, 0], [16, 0, 0, 0], [2, 32, 16, 0], [16, 256, 64, 4]]",69800,right,0,"[[2, 0, 0, 2], [0, 0, 0, 16], [0, 2, 32, 16], [16, 256, 64, 4]]",69800
5,"[[2, 0, 0, 2], [0, 0, 0, 16], [0, 2, 32, 16], [16, 256, 64, 4]]",69800,down,32,"[[0, 0, 2, 0], [0, 0, 0, 2], [2, 2, 32, 32], [16, 256, 64, 4]]",69832
5,"[[0, 0, 2, 0], [0, 0, 0, 2], [2, 2, 32, 32], [16, 256, 64, 4]]",69832,left,68,"[[2, 0, 0, 0], [2, 2, 0, 0], [4, 64, 0, 0], [16, 256, 64, 4]]",69900
5,"[[2, 0, 0, 0], [2, 2, 0, 0], [4, 64, 0, 0], [16, 256, 64, 4]]",69900,up,4,"[[4, 2, 64, 4], [4, 64, 0, 0], [16, 256, 2, 0], [0, 0, 0, 0]]",69904
5,"[[4, 2, 64, 4], [4, 64, 0, 0], [16, 256, 2, 0], [0, 0, 0, 0]]",69904,down,8,"[[0, 4, 0, 0], [0, 2, 0, 0], [8, 64, 64, 0], [16, 256, 2, 4]]",69912
5,"[[0, 4, 0, 0], [0, 2, 0, 0], [8, 64, 64, 0], [16, 256, 2, 4]]",69912,left,128,"[[4, 0, 0, 0], [2, 0, 0, 2], [8, 128, 0, 0], [16, 256, 2, 4]]",70040
5,"[[4, 0, 0, 0], [2, 0, 0, 2], [8, 128, 0, 0], [16, 256, 2, 4]]",70040,left,4,"[[4, 0, 2, 0], [4, 0, 0, 0], [8, 128, 0, 0], [16, 256, 2, 4]]",70044
5,"[[4, 0, 2, 0], [4, 0, 0, 0], [8, 128, 0, 0], [16, 256, 2, 4]]",70044,up,12,"[[8, 128, 4, 4], [8, 256, 0, 0], [16, 0, 0, 0], [0, 4, 0, 0]]",70056
5,"[[8, 128, 4, 4], [8, 256, 0, 0], [16, 0, 0, 0], [0, 4, 0, 0]]",70056,up,16,"[[16, 128, 4, 4], [16, 256, 0, 4], [0, 4, 0, 0], [0, 0, 0, 0]]",70072
5,"[[16, 128, 4, 4], [16, 256, 0, 4], [0, 4, 0, 0], [0, 0, 0, 0]]",70072,down,40,"[[0, 0, 0, 0], [0, 128, 0, 0], [0, 256, 2, 0], [32, 4, 4, 8]]",70112
5,"[[0, 0, 0, 0], [0, 128, 0, 0], [0, 256, 2, 0], [32, 4, 4, 8]]",70112,left,8,"[[4, 0, 0, 0], [128, 0, 0, 0], [256, 2, 0, 0], [32, 8, 8, 0]]",70120
5,"[[4, 0, 0, 0], [128, 0, 0, 0], [256, 2, 0, 0], [32, 8, 8, 0]]",70120,left,16,"[[4, 0, 4, 0], [128, 0, 0, 0], [256, 2, 0, 0], [32, 16, 0, 0]]",70136
5,"[[4, 0, 4, 0], [128, 0, 0, 0], [256, 2, 0, 0], [32, 16, 0, 0]]",70136,left,8,"[[8, 0, 0, 0], [128, 0, 0, 0], [256, 2, 0, 4], [32, 16, 0, 0]]",70144
5,"[[8, 0, 0, 0], [128, 0, 0, 0], [256, 2, 0, 4], [32, 16, 0, 0]]",70144,down,0,"[[8, 0, 0, 0], [128, 2, 0, 0], [256, 2, 0, 0], [32, 16, 0, 4]]",70144
5,"[[8, 0, 0, 0], [128, 2, 0, 0], [256, 2, 0, 0], [32, 16, 0, 4]]",70144,up,4,"[[8, 4, 0, 4], [128, 16, 0, 0], [256, 0, 0, 0], [32, 4, 0, 0]]",70148
5,"[[8, 4, 0, 4], [128, 16, 0, 0], [256, 0, 0, 0], [32, 4, 0, 0]]",70148,right,8,"[[2, 0, 8, 8], [0, 0, 128, 16], [0, 0, 0, 256], [0, 0, 32, 4]]",70156
5,"[[2, 0, 8, 8], [0, 0, 128, 16], [0, 0, 0, 256], [0, 0, 32, 4]]",70156,right,16,"[[0, 0, 2, 16], [0, 0, 128, 16], [0, 0, 2, 256], [0, 0, 32, 4]]",70172
5,"[[0, 0, 2, 16], [0, 0, 128, 16], [0, 0, 2, 256], [0, 0, 32, 4]]",70172,up,32,"[[0, 0, 2, 32], [0, 0, 128, 256], [0, 4, 2, 4], [0, 0, 32, 0]]",70204
5,"[[0, 0, 2, 32], [0, 0, 128, 256], [0, 4, 2, 4], [0, 0, 32, 0]]",70204,down,0,"[[0, 0, 2, 0], [0, 0, 128, 32], [0, 2, 2, 256], [0, 4, 32, 4]]",70204
5,"[[0, 0, 2, 0], [0, 0, 128, 32], [0, 2, 2, 256], [0, 4, 32, 4]]",70204,left,4,"[[2, 0, 2, 0], [128, 32, 0, 0], [4, 256, 0, 0], [4, 32, 4, 0]]",70208
5,"[[2, 0, 2, 0], [128, 32, 0, 0], [4, 256, 0, 0], [4, 32, 4, 0]]",70208,right,4,"[[0, 0, 0, 4], [0, 0, 128, 32], [0, 0, 4, 256], [2, 4, 32, 4]]",70212
5,"[[0, 0, 0, 4], [0, 0, 128, 32], [0, 0, 4, 256], [2, 4, 32, 4]]",70212,up,0,"[[2, 4, 128, 4], [0, 0, 4, 32], [0, 0, 32, 256], [0, 2, 0, 4]]",70212
5,"[[2, 4, 128, 4], [0, 0, 4, 32], [0, 0, 32, 256], [0, 2, 0, 4]]",70212,right,0,"[[2, 4, 128, 4], [0, 0, 4, 32], [0, 2, 32, 256], [0, 0, 2, 4]]",70212
5,"[[2, 4, 128, 4], [0, 0, 4, 32], [0, 2, 32, 256], [0, 0, 2, 4]]",70212,left,0,"[[2, 4, 128, 4], [4, 32, 0, 0], [2, 32, 256, 0], [2, 4, 4, 0]]",70212
5,"[[2, 4, 128, 4], [4, 32, 0, 0], [2, 32, 256, 0], [2, 4, 4, 0]]",70212,down,68,"[[0, 0, 2, 0], [2, 4, 128, 0], [4, 64, 256, 0], [4, 4, 4, 4]]",70280
5,"[[0, 0, 2, 0], [2, 4, 128, 0], [4, 64, 256, 0], [4, 4, 4, 4]]",70280,left,16,"[[2, 0, 0, 0], [2, 4, 128, 4], [4, 64, 256, 0], [8, 8, 0, 0]]",70296
5,"[[2, 0, 0, 0], [2, 4, 128, 4], [4, 64, 256, 0], [8, 8, 0, 0]]",70296,right,16,"[[0, 0, 0, 2], [2, 4, 128, 4], [0, 4, 64, 256], [2, 0, 0, 16]]",70312
5,"[[0, 0, 0, 2], [2, 4, 128, 4], [0, 4, 64, 256], [2, 0, 0, 16]]",70312,up,12,"[[4, 8, 128, 2], [0, 0, 64, 4], [0, 0, 0, 256], [0, 4, 0, 16]]",70324
5,"[[4, 8, 128, 2], [0, 0, 64, 4], [0, 0, 0, 256], [0, 4, 0, 16]]",70324,down,0,"[[0, 0, 0, 2], [0, 0, 4, 4], [0, 8, 128, 256], [4, 4, 64, 16]]",70324
5,"[[0, 0, 0, 2], [0, 0, 4, 4], [0, 8, 128, 256], [4, 4, 64, 16]]",70324,left,16,"[[2, 0, 0, 0], [8, 2, 0, 0], [8, 128, 256, 0], [8, 64, 16, 0]]",70340
5,"[[2, 0, 0, 0], [8, 2, 0, 0], [8, 128, 256, 0], [8, 64, 16, 0]]",70340,down,16,"[[0, 0, 0, 2], [2, 2, 0, 0], [8, 128, 256, 0], [16, 64, 16, 0]]",70356
5,"[[0, 0, 0, 2], [2, 2, 0, 0], [8, 128, 256, 0], [16, 64, 16, 0]]",70356,right,4,"[[0, 0, 0, 2], [0, 4, 0, 4], [0, 8, 128, 256], [0, 16, 64, 16]]",70360
5,"[[0, 0, 0, 2], [0, 4, 0, 4], [0, 8, 128, 256], [0, 16, 64, 16]]",70360,left,8,"[[2, 0, 0, 0], [8, 0, 0, 2], [8, 128, 256, 0], [16, 64, 16, 0]]",70368
5,"[[2, 0, 0, 0], [8, 0, 0, 2], [8, 128, 256, 0], [16, 64, 16, 0]]",70368,up,16,"[[2, 128, 256, 2], [16, 64, 16, 0], [16, 4, 0, 0], [0, 0, 0, 0]]",70384
5,"[[2, 128, 256, 2], [16, 64, 16, 0], [16, 4, 0, 0], [0, 0, 0, 0]]",70384,up,32,"[[2, 128, 256, 2], [32, 64, 16, 0], [0, 4, 0, 0], [0, 0, 0, 2]]",70416
5,"[[2, 128, 256, 2], [32, 64, 16, 0], [0, 4, 0, 0], [0, 0, 0, 2]]",70416,up,4,"[[2, 128, 256, 4], [32, 64, 16, 0], [0, 4, 0, 0], [0, 2, 0, 0]]",70420
5,"[[2, 128, 256, 4], [32, 64, 16, 0], [0, 4, 0, 0], [0, 2, 0, 0]]",70420,left,0,"[[2, 128, 256, 4], [32, 64, 16, 0], [4, 4, 0, 0], [2, 0, 0, 0]]",70420
5,"[[2, 128, 256, 4], [32, 64, 16, 0], [4, 4, 0, 0], [2, 0, 0, 0]]",70420,right,8,"[[2, 128, 256, 4], [2, 32, 64, 16], [0, 0, 0, 8], [0, 0, 0, 2]]",70428
5,"[[2, 128, 256, 4], [2, 32, 64, 16], [0, 0, 0, 8], [0, 0, 0, 2]]",70428,up,4,"[[4, 128, 256, 4], [2, 32, 64, 16], [0, 0, 0, 8], [0, 0, 0, 2]]",70432
5,"[[4, 128, 256, 4], [2, 32, 64, 16], [0, 0, 0, 8], [0, 0, 0, 2]]",70432,right,0,"[[4, 128, 256, 4], [2, 32, 64, 16], [0, 0, 2, 8], [0, 0, 0, 2]]",70432
5,"[[4, 128, 256, 4], [2, 32, 64, 16], [0, 0, 2, 8], [0, 0, 0, 2]]",70432,left,0,"[[4, 128, 256, 4], [2, 32, 64, 16], [2, 8, 0, 0], [2, 2, 0, 0]]",70432
5,"[[4, 128, 256, 4], [2, 32, 64, 16], [2, 8, 0, 0], [2, 2, 0, 0]]",70432,up,4,"[[4, 128, 256, 4], [4, 32, 64, 16], [2, 8, 0, 0], [0, 2, 4, 0]]",70436
5,"[[4, 128, 256, 4], [4, 32, 64, 16], [2, 8, 0, 0], [0, 2, 4, 0]]",70436,down,8,"[[0, 128, 0, 0], [0, 32, 256, 2], [8, 8, 64, 4], [2, 2, 4, 16]]",70444
5,"[[0, 128, 0, 0], [0, 32, 256, 2], [8, 8, 64, 4], [2, 2, 4, 16]]",70444,right,20,"[[2, 0, 0, 128], [0, 32, 256, 2], [0, 16, 64, 4], [0, 4, 4, 16]]",70464
5,"[[2, 0, 0, 128], [0, 32, 256, 2], [0, 16, 64, 4], [0, 4, 4, 16]]",70464,right,8,"[[0, 4, 2, 128], [0, 32, 256, 2], [0, 16, 64, 4], [0, 0, 8, 16]]",70472
5,"[[0, 4, 2, 128], [0, 32, 256, 2], [0, 16, 64, 4], [0, 0, 8, 16]]",70472,left,0,"[[4, 2, 128, 0], [32, 256, 2, 0], [16, 64, 4, 4], [8, 16, 0, 0]]",70472
5,"[[4, 2, 128, 0], [32, 256, 2, 0], [16, 64, 4, 4], [8, 16, 0, 0]]",70472,left,8,"[[4, 2, 128, 0], [32, 256, 2, 0], [16, 64, 8, 0], [8, 16, 0, 2]]",70480
5,"[[4, 2, 128, 0], [32, 256, 2, 0], [16, 64, 8, 0], [8, 16, 0, 2]]",70480,down,0,"[[4, 2, 0, 4], [32, 256, 128, 0], [16, 64, 2, 0], [8, 16, 8, 2]]",70480
5,"[[4, 2, 0, 4], [32, 256, 128, 0], [16, 64, 2, 0], [8, 16, 8, 2]]",70480,right,0,"[[0, 4, 2, 4], [4, 32, 256, 128], [0, 16, 64, 2], [8, 16, 8, 2]]",70480
5,"[[0, 4, 2, 4], [4, 32, 256, 128], [0, 16, 64, 2], [8, 16, 8, 2]]",70480,down,36,"[[0, 0, 2, 0], [4, 4, 256, 4], [4, 32, 64, 128], [8, 32, 8, 4]]",70516
5,"[[0, 0, 2, 0], [4, 4, 256, 4], [4, 32, 64, 128], [8, 32, 8, 4]]",70516,down,72,"[[0, 0, 2, 0], [0, 4, 256, 4], [8, 4, 64, 128], [8, 64, 8, 4]]",70588
5,"[[0, 0, 2, 0], [0, 4, 256, 4], [8, 4, 64, 128], [8, 64, 8, 4]]",70588,down,24,"[[0, 2, 2, 0], [0, 0, 256, 4], [0, 8, 64, 128], [16, 64, 8, 4]]",70612
5,"[[0, 2, 2, 0], [0, 0, 256, 4], [0, 8, 64, 128], [16, 64, 8, 4]]",70612,up,0,"[[16, 2, 2, 4], [0, 8, 256, 128], [2, 64, 64, 4], [0, 0, 8, 0]]",70612
5,"[[16, 2, 2, 4], [0, 8, 256, 128], [2, 64, 64, 4], [0, 0, 8, 0]]",70612,left,132,"[[16, 4, 4, 0], [8, 256, 128, 0], [2, 128, 4, 0], [8, 0, 4, 0]]",70744
5,"[[16, 4, 4, 0], [8, 256, 128, 0], [2, 128, 4, 0], [8, 0, 4, 0]]",70744,left,8,"[[16, 8, 4, 0], [8, 256, 128, 0], [2, 128, 4, 0], [8, 4, 0, 0]]",70752
5,"[[16, 8, 4, 0], [8, 256, 128, 0], [2, 128, 4, 0], [8, 4, 0, 0]]",70752,up,0,"[[16, 8, 4, 0], [8, 256, 128, 0], [2, 128, 4, 0], [8, 4, 4, 0]]",70752
5,"[[16, 8, 4, 0], [8, 256, 128, 0], [2, 128, 4, 0], [8, 4, 4, 0]]",70752,down,8,"[[16, 8, 4, 0], [8, 256, 4, 0], [2, 128, 128, 0], [8, 4, 8, 0]]",70760
5,"[[16, 8, 4, 0], [8, 256, 4, 0], [2, 128, 128, 0], [8, 4, 8, 0]]",70760,left,256,"[[16, 8, 4, 0], [8, 256, 4, 4], [2, 256, 0, 0], [8, 4, 8, 0]]",71016
5,"[[16, 8, 4, 0], [8, 256, 4, 4], [2, 256, 0, 0], [8, 4, 8, 0]]",71016,up,520,"[[16, 8, 8, 4], [8, 512, 8, 2], [2, 4, 0, 0], [8, 0, 0, 0]]",71536
5,"[[16, 8, 8, 4], [8, 512, 8, 2], [2, 4, 0, 0], [8, 0, 0, 0]]",71536,left,16,"[[16, 16, 4, 0], [8, 512, 8, 2], [2, 4, 0, 0], [8, 0, 0, 4]]",71552
5,"[[16, 16, 4, 0], [8, 512, 8, 2], [2, 4, 0, 0], [8, 0, 0, 4]]",71552,left,32,"[[32, 4, 4, 0], [8, 512, 8, 2], [2, 4, 0, 0], [8, 4, 0, 0]]",71584
5,"[[32, 4, 4, 0], [8, 512, 8, 2], [2, 4, 0, 0], [8, 4, 0, 0]]",71584,down,8,"[[32, 0, 0, 0], [8, 4, 0, 0], [2, 512, 4, 4], [8, 8, 8, 2]]",71592
5,"[[32, 0, 0, 0], [8, 4, 0, 0], [2, 512, 4, 4], [8, 8, 8, 2]]",71592,left,24,"[[32, 0, 4, 0], [8, 4, 0, 0], [2, 512, 8, 0], [16, 8, 2, 0]]",71616
5,"[[32, 0, 4, 0], [8, 4, 0, 0], [2, 512, 8, 0], [16, 8, 2, 0]]",71616,right,0,"[[0, 0, 32, 4], [0, 0, 8, 4], [2, 2, 512, 8], [0, 16, 8, 2]]",71616
5,"[[0, 0, 32, 4], [0, 0, 8, 4], [2, 2, 512, 8], [0, 16, 8, 2]]",71616,up,8,"[[2, 2, 32, 8], [0, 16, 8, 8], [0, 0, 512, 2], [0, 0, 8, 2]]",71624
5,"[[2, 2, 32, 8], [0, 16, 8, 8], [0, 0, 512, 2], [0, 0, 8, 2]]",71624,right,20,"[[0, 4, 32, 8], [0, 2, 16, 16], [0, 0, 512, 2], [0, 0, 8, 2]]",71644
5,"[[0, 4, 32, 8], [0, 2, 16, 16], [0, 0, 512, 2], [0, 0, 8, 2]]",71644,left,32,"[[4, 32, 8, 0], [2, 32, 0, 0], [512, 2, 0, 2], [8, 2, 0, 0]]",71676
5,"[[4, 32, 8, 0], [2, 32, 0, 0], [512, 2, 0, 2], [8, 2, 0, 0]]",71676,up,68,"[[4, 64, 8, 2], [2, 4, 0, 2], [512, 0, 0, 0], [8, 0, 0, 0]]",71744
5,"[[4, 64, 8, 2], [2, 4, 0, 2], [512, 0, 0, 0], [8, 0, 0, 0]]",71744,up,4,"[[4, 64, 8, 4], [2, 4, 0, 4], [512, 0, 0, 0], [8, 0, 0, 0]]",71748
5,"[[4, 64, 8, 4], [2, 4, 0, 4], [512, 0, 0, 0], [8, 0, 0, 0]]",71748,up,8,"[[4, 64, 8, 8], [2, 4, 0, 0], [512, 0, 2, 0], [8, 0, 0, 0]]",71756
5,"[[4, 64, 8, 8], [2, 4, 0, 0], [512, 0, 2, 0], [8, 0, 0, 0]]",71756,right,16,"[[2, 4, 64, 16], [0, 0, 2, 4], [0, 0, 512, 2], [0, 0, 0, 8]]",71772
5,"[[2, 4, 64, 16], [0, 0, 2, 4], [0, 0, 512, 2], [0, 0, 0, 8]]",71772,left,0,"[[2, 4, 64, 16], [2, 4, 0, 0], [512, 2, 0, 0], [8, 0, 0, 4]]",71772
5,"[[2, 4, 64, 16], [2, 4, 0, 0], [512, 2, 0, 0], [8, 0, 0, 4]]",71772,up,12,"[[4, 8, 64, 16], [512, 2, 0, 4], [8, 0, 0, 0], [0, 0, 2, 0]]",71784
5,"[[4, 8, 64, 16], [512, 2, 0, 4], [8, 0, 0, 0], [0, 0, 2, 0]]",71784,down,0,"[[0, 0, 0, 0], [4, 2, 0, 0], [512, 8, 64, 16], [8, 2, 2, 4]]",71784
5,"[[0, 0, 0, 0], [4, 2, 0, 0], [512, 8, 64, 16], [8, 2, 2, 4]]",71784,right,4,"[[0, 0, 0, 0], [0, 4, 4, 2], [512, 8, 64, 16], [0, 8, 4, 4]]",71788
5,"[[0, 0, 0, 0], [0, 4, 4, 2], [512, 8, 64, 16], [0, 8, 4, 4]]",71788,left,16,"[[0, 0, 0, 0], [8, 2, 0, 4], [512, 8, 64, 16], [8, 8, 0, 0]]",71804
5,"[[0, 0, 0, 0], [8, 2, 0, 4], [512, 8, 64, 16], [8, 8, 0, 0]]",71804,right,16,"[[0, 0, 0, 4], [0, 8, 2, 4], [512, 8, 64, 16], [0, 0, 0, 16]]",71820
5,"[[0, 0, 0, 4], [0, 8, 2, 4], [512, 8, 64, 16], [0, 0, 0, 16]]",71820,down,56,"[[0, 0, 0, 2], [0, 0, 0, 0], [0, 0, 2, 8], [512, 16, 64, 32]]",71876
5,"[[0, 0, 0, 2], [0, 0, 0, 0], [0, 0, 2, 8], [512, 16, 64, 32]]",71876,down,0,"[[0, 0, 2, 0], [0, 0, 0, 2], [0, 0, 2, 8], [512, 16, 64, 32]]",71876
5,"[[0, 0, 2, 0], [0, 0, 0, 2], [0, 0, 2, 8], [512, 16, 64, 32]]",71876,down,4,"[[0, 0, 0, 4], [0, 0, 0, 2], [0, 0, 4, 8], [512, 16, 64, 32]]",71880
5,"[[0, 0, 0, 4], [0, 0, 0, 2], [0, 0, 4, 8], [512, 16, 64, 32]]",71880,down,0,"[[0, 0, 0, 4], [0, 0, 0, 2], [2, 0, 4, 8], [512, 16, 64, 32]]",71880
5,"[[0, 0, 0, 4], [0, 0, 0, 2], [2, 0, 4, 8], [512, 16, 64, 32]]",71880,left,0,"[[4, 0, 0, 0], [2, 0, 0, 2], [2, 4, 8, 0], [512, 16, 64, 32]]",71880
5,"[[4, 0, 0, 0], [2, 0, 0, 2], [2, 4, 8, 0], [512, 16, 64, 32]]",71880,down,4,"[[0, 0, 0, 0], [4, 4, 0, 0], [4, 4, 8, 2], [512, 16, 64, 32]]",71884
5,"[[0, 0, 0, 0], [4, 4, 0, 0], [4, 4, 8, 2], [512, 16, 64, 32]]",71884,left,16,"[[4, 0, 0, 0], [8, 0, 0, 0], [8, 8, 2, 0], [512, 16, 64, 32]]",71900
5,"[[4, 0, 0, 0], [8, 0, 0, 0], [8, 8, 2, 0], [512, 16, 64, 32]]",71900,up,16,"[[4, 8, 2, 32], [16, 16, 64, 0], [512, 0, 0, 0], [0, 0, 4, 0]]",71916
5,"[[4, 8, 2, 32], [16, 16, 64, 0], [512, 0, 0, 0], [0, 0, 4, 0]]",71916,right,32,"[[4, 8, 2, 32], [0, 2, 32, 64], [0, 0, 0, 512], [0, 0, 0, 4]]",71948
5,"[[4, 8, 2, 32], [0, 2, 32, 64], [0, 0, 0, 512], [0, 0, 0, 4]]",71948,down,0,"[[0, 0, 0, 32], [0, 0, 0, 64], [4, 8, 2, 512], [4, 2, 32, 4]]",71948
5,"[[0, 0, 0, 32], [0, 0, 0, 64], [4, 8, 2, 512], [4, 2, 32, 4]]",71948,up,8,"[[8, 8, 2, 32], [0, 2, 32, 64], [0, 0, 0, 512], [0, 2, 0, 4]]",71956
5,"[[8, 8, 2, 32], [0, 2, 32, 64], [0, 0, 0, 512], [0, 2, 0, 4]]",71956,left,16,"[[16, 2, 32, 0], [2, 32, 64, 0], [512, 0, 0, 0], [2, 4, 2, 0]]",71972
5,"[[16, 2, 32, 0], [2, 32, 64, 0], [512, 0, 0, 0], [2, 4, 2, 0]]",71972,up,0,"[[16, 2, 32, 0], [2, 32, 64, 0], [512, 4, 2, 4], [2, 0, 0, 0]]",71972
5,"[[16, 2, 32, 0], [2, 32, 64, 0], [512, 4, 2, 4], [2, 0, 0, 0]]",71972,down,0,"[[16, 0, 0, 0], [2, 2, 32, 0], [512, 32, 64, 4], [2, 4, 2, 4]]",71972
5,"[[16, 0, 0, 0], [2, 2, 32, 0], [512, 32, 64, 4], [2, 4, 2, 4]]",71972,left,4,"[[16, 0, 0, 0], [4, 32, 0, 4], [512, 32, 64, 4], [2, 4, 2, 4]]",71976
5,"[[16, 0, 0, 0], [4, 32, 0, 4], [512, 32, 64, 4], [2, 4, 2, 4]]",71976,down,72,"[[16, 4, 0, 0], [4, 0, 0, 0], [512, 64, 64, 4], [2, 4, 2, 8]]",72048
5,"[[16, 4, 0, 0], [4, 0, 0, 0], [512, 64, 64, 4], [2, 4, 2, 8]]",72048,right,128,"[[0, 4, 16, 4], [0, 0, 0, 4], [0, 512, 128, 4], [2, 4, 2, 8]]",72176
5,"[[0, 4, 16, 4], [0, 0, 0, 4], [0, 512, 128, 4], [2, 4, 2, 8]]",72176,down,8,"[[0, 0, 0, 0], [4, 4, 16, 4], [0, 512, 128, 8], [2, 4, 2, 8]]",72184
5,"[[0, 0, 0, 0], [4, 4, 16, 4], [0, 512, 128, 8], [2, 4, 2, 8]]",72184,up,16,"[[4, 4, 16, 4], [2, 512, 128, 16], [0, 4, 2, 0], [2, 0, 0, 0]]",72200
5,"[[4, 4, 16, 4], [2, 512, 128, 16], [0, 4, 2, 0], [2, 0, 0, 0]]",72200,up,4,"[[4, 4, 16, 4], [4, 512, 128, 16], [2, 4, 2, 0], [0, 0, 0, 0]]",72204
5,"[[4, 4, 16, 4], [4, 512, 128, 16], [2, 4, 2, 0], [0, 0, 0, 0]]",72204,right,8,"[[0, 8, 16, 4], [4, 512, 128, 16], [4, 2, 4, 2], [0, 0, 0, 0]]",72212
5,"[[0, 8, 16, 4], [4, 512, 128, 16], [4, 2, 4, 2], [0, 0, 0, 0]]",72212,up,8,"[[8, 8, 16, 4], [0, 512, 128, 16], [0, 2, 4, 2], [2, 0, 0, 0]]",72220
5,"[[8, 8, 16, 4], [0, 512, 128, 16], [0, 2, 4, 2], [2, 0, 0, 0]]",72220,left,16,"[[16, 16, 4, 0], [512, 128, 16, 2], [2, 4, 2, 0], [2, 0, 0, 0]]",72236
5,"[[16, 16, 4, 0], [512, 128, 16, 2], [2, 4, 2, 0], [2, 0, 0, 0]]",72236,left,32,"[[32, 4, 0, 0], [512, 128, 16, 2], [2, 4, 2, 0], [2, 0, 0, 2]]",72268
5,"[[32, 4, 0, 0], [512, 128, 16, 2], [2, 4, 2, 0], [2, 0, 0, 2]]",72268,up,8,"[[32, 4, 16, 4], [512, 128, 2, 0], [4, 4, 0, 2], [0, 0, 0, 0]]",72276
5,"[[32, 4, 16, 4], [512, 128, 2, 0], [4, 4, 0, 2], [0, 0, 0, 0]]",72276,right,8,"[[32, 4, 16, 4], [0, 512, 128, 2], [2, 0, 8, 2], [0, 0, 0, 0]]",72284
5,"[[32, 4, 16, 4], [0, 512, 128, 2], [2, 0, 8, 2], [0, 0, 0, 0]]",72284,up,4,"[[32, 4, 16, 4], [2, 512, 128, 4], [0, 0, 8, 0], [0, 0, 0, 4]]",72288
5,"[[32, 4, 16, 4], [2, 512, 128, 4], [0, 0, 8, 0], [0, 0, 0, 4]]",72288,down,8,"[[0, 0, 0, 4], [0, 0, 16, 0], [32, 4, 128, 4], [2, 512, 8, 8]]",72296
5,"[[0, 0, 0, 4], [0, 0, 16, 0], [32, 4, 128, 4], [2, 512, 8, 8]]",72296,down,8,"[[0, 0, 2, 0], [0, 0, 16, 0], [32, 4, 128, 8], [2, 512, 8, 8]]",72304
5,"[[0, 0, 2, 0], [0, 0, 16, 0], [32, 4, 128, 8], [2, 512, 8, 8]]",72304,up,16,"[[32, 4, 2, 16], [2, 512, 16, 0], [0, 2, 128, 0], [0, 0, 8, 0]]",72320
5,"[[32, 4, 2, 16], [2, 512, 16, 0], [0, 2, 128, 0], [0, 0, 8, 0]]",72320,right,0,"[[32, 4, 2, 16], [0, 2, 512, 16], [0, 0, 2, 128], [0, 2, 0, 8]]",72320
5,"[[32, 4, 2, 16], [0, 2, 512, 16], [0, 0, 2, 128], [0, 2, 0, 8]]",72320,down,36,"[[0, 0, 0, 0], [4, 0, 2, 32], [0, 4, 512, 128], [32, 4, 2, 8]]",72356
5,"[[0, 0, 0, 0], [4, 0, 2, 32], [0, 4, 512, 128], [32, 4, 2, 8]]",72356,down,8,"[[0, 0, 0, 0], [0, 2, 2, 32], [4, 0, 512, 128], [32, 8, 2, 8]]",72364
5,"[[0, 0, 0, 0], [0, 2, 2, 32], [4, 0, 512, 128], [32, 8, 2, 8]]",72364,left,4,"[[0, 2, 0, 0], [4, 32, 0, 0], [4, 512, 128, 0], [32, 8, 2, 8]]",72368
5,"[[0, 2, 0, 0], [4, 32, 0, 0], [4, 512, 128, 0], [32, 8, 2, 8]]",72368,up,8,"[[8, 2, 128, 8], [32, 32, 2, 0], [0, 512, 0, 0], [2, 8, 0, 0]]",72376
5,"[[8, 2, 128, 8], [32, 32, 2, 0], [0, 512, 0, 0], [2, 8, 0, 0]]",72376,left,64,"[[8, 2, 128, 8], [64, 2, 0, 0], [512, 4, 0, 0], [2, 8, 0, 0]]",72440
5,"[[8, 2, 128, 8], [64, 2, 0, 0], [512, 4, 0, 0], [2, 8, 0, 0]]",72440,up,4,"[[8, 4, 128, 8], [64, 4, 0, 0], [512, 8, 0, 0], [2, 4, 0, 0]]",72444
5,"[[8, 4, 128, 8], [64, 4, 0, 0], [512, 8, 0, 0], [2, 4, 0, 0]]",72444,up,8,"[[8, 8, 128, 8], [64, 8, 0, 0], [512, 4, 0, 0], [2, 0, 0, 4]]",72452
5,"[[8, 8, 128, 8], [64, 8, 0, 0], [512, 4, 0, 0], [2, 0, 0, 4]]",72452,right,16,"[[0, 16, 128, 8], [0, 0, 64, 8], [0, 4, 512, 4], [0, 0, 2, 4]]",72468
5,"[[0, 16, 128, 8], [0, 0, 64, 8], [0, 4, 512, 4], [0, 0, 2, 4]]",72468,up,24,"[[4, 16, 128, 16], [0, 4, 64, 8], [0, 0, 512, 0], [0, 0, 2, 0]]",72492
5,"[[4, 16, 128, 16], [0, 4, 64, 8], [0, 0, 512, 0], [0, 0, 2, 0]]",72492,right,0,"[[4, 16, 128, 16], [0, 4, 64, 8], [0, 0, 0, 512], [0, 0, 2, 2]]",72492
5,"[[4, 16, 128, 16], [0, 4, 64, 8], [0, 0, 0, 512], [0, 0, 2, 2]]",72492,left,4,"[[4, 16, 128, 16], [4, 64, 8, 0], [512, 0, 0, 4], [4, 0, 0, 0]]",72496
5,"[[4, 16, 128, 16], [4, 64, 8, 0], [512, 0, 0, 4], [4, 0, 0, 0]]",72496,right,0,"[[4, 16, 128, 16], [2, 4, 64, 8], [0, 0, 512, 4], [0, 0, 0, 4]]",72496
5,"[[4, 16, 128, 16], [2, 4, 64, 8], [0, 0, 512, 4], [0, 0, 0, 4]]",72496,down,8,"[[2, 0, 0, 0], [0, 0, 128, 16], [4, 16, 64, 8], [2, 4, 512, 8]]",72504
5,"[[2, 0, 0, 0], [0, 0, 128, 16], [4, 16, 64, 8], [2, 4, 512, 8]]",72504,up,16,"[[2, 16, 128, 16], [4, 4, 64, 16], [2, 0, 512, 0], [2, 0, 0, 0]]",72520
5,"[[2, 16, 128, 16], [4, 4, 64, 16], [2, 0, 512, 0], [2, 0, 0, 0]]",72520,down,36,"[[0, 0, 2, 0], [2, 0, 128, 0], [4, 16, 64, 0], [4, 4, 512, 32]]",72556
5,"[[0, 0, 2, 0], [2, 0, 128, 0], [4, 16, 64, 0], [4, 4, 512, 32]]",72556,right,8,"[[0, 0, 0, 2], [4, 0, 2, 128], [0, 4, 16, 64], [0, 8, 512, 32]]",72564
5,"[[0, 0, 0, 2], [4, 0, 2, 128], [0, 4, 16, 64], [0, 8, 512, 32]]",72564,left,0,"[[2, 0, 0, 0], [4, 2, 128, 4], [4, 16, 64, 0], [8, 512, 32, 0]]",72564
5,"[[2, 0, 0, 0], [4, 2, 128, 4], [4, 16, 64, 0], [8, 512, 32, 0]]",72564,up,8,"[[2, 2, 128, 4], [8, 16, 64, 0], [8, 512, 32, 0], [0, 0, 0, 2]]",72572
5,"[[2, 2, 128, 4], [8, 16, 64, 0], [8, 512, 32, 0], [0, 0, 0, 2]]",72572,up,16,"[[2, 2, 128, 4], [16, 16, 64, 2], [0, 512, 32, 0], [4, 0, 0, 0]]",72588
5,"[[2, 2, 128, 4], [16, 16, 64, 2], [0, 512, 32, 0], [4, 0, 0, 0]]",72588,left,36,"[[4, 128, 4, 0], [32, 64, 2, 0], [512, 32, 0, 0], [4, 0, 0, 2]]",72624
5,"[[4, 128, 4, 0], [32, 64, 2, 0], [512, 32, 0, 0], [4, 0, 0, 2]]",72624,left,0,"[[4, 128, 4, 0], [32, 64, 2, 0], [512, 32, 0, 0], [4, 2, 2, 0]]",72624
5,"[[4, 128, 4, 0], [32, 64, 2, 0], [512, 32, 0, 0], [4, 2, 2, 0]]",72624,down,4,"[[4, 128, 2, 0], [32, 64, 0, 0], [512, 32, 4, 0], [4, 2, 4, 0]]",72628
5,"[[4, 128, 2, 0], [32, 64, 0, 0], [512, 32, 4, 0], [4, 2, 4, 0]]",72628,right,0,"[[0, 4, 128, 2], [2, 0, 32, 64], [0, 512, 32, 4], [0, 4, 2, 4]]",72628
5,"[[0, 4, 128, 2], [2, 0, 32, 64], [0, 512, 32, 4], [0, 4, 2, 4]]",72628,up,72,"[[2, 4, 128, 2], [0, 512, 64, 64], [0, 4, 2, 8], [0, 0, 0, 2]]",72700
5,"[[2, 4, 128, 2], [0, 512, 64, 64], [0, 4, 2, 8], [0, 0, 0, 2]]",72700,right,128,"[[2, 4, 128, 2], [0, 0, 512, 128], [0, 4, 2, 8], [0, 4, 0, 2]]",72828
5,"[[2, 4, 128, 2], [0, 0, 512, 128], [0, 4, 2, 8], [0, 4, 0, 2]]",72828,down,8,"[[0, 0, 0, 2], [4, 0, 128, 128], [0, 4, 512, 8], [2, 8, 2, 2]]",72836
5,"[[0, 0, 0, 2], [4, 0, 128, 128], [0, 4, 512, 8], [2, 8, 2, 2]]",72836,left,260,"[[2, 0, 2, 0], [4, 256, 0, 0], [4, 512, 8, 0], [2, 8, 4, 0]]",73096
5,"[[2, 0, 2, 0], [4, 256, 0, 0], [4, 512, 8, 0], [2, 8, 4, 0]]",73096,right,4,"[[0, 0, 0, 4], [0, 0, 4, 256], [0, 4, 512, 8], [2, 2, 8, 4]]",73100
5,"[[0, 0, 0, 4], [0, 0, 4, 256], [0, 4, 512, 8], [2, 2, 8, 4]]",73100,right,4,"[[2, 0, 0, 4], [0, 0, 4, 256], [0, 4, 512, 8], [0, 4, 8, 4]]",73104
5,"[[2, 0, 0, 4], [0, 0, 4, 256], [0, 4, 512, 8], [0, 4, 8, 4]]",73104,up,8,"[[2, 8, 4, 4], [0, 0, 512, 256], [0, 4, 8, 8], [0, 0, 0, 4]]",73112
5,"[[2, 8, 4, 4], [0, 0, 512, 256], [0, 4, 8, 8], [0, 0, 0, 4]]",73112,left,24,"[[2, 8, 8, 0], [512, 256, 0, 0], [4, 16, 0, 0], [4, 0, 4, 0]]",73136
5,"[[2, 8, 8, 0], [512, 256, 0, 0], [4, 16, 0, 0], [4, 0, 4, 0]]",73136,right,24,"[[0, 0, 2, 16], [4, 0, 512, 256], [0, 0, 4, 16], [0, 0, 0, 8]]",73160
5,"[[0, 0, 2, 16], [4, 0, 512, 256], [0, 0, 4, 16], [0, 0, 0, 8]]",73160,down,0,"[[0, 0, 0, 16], [0, 4, 2, 256], [0, 0, 512, 16], [4, 0, 4, 8]]",73160
5,"[[0, 0, 0, 16], [0, 4, 2, 256], [0, 0, 512, 16], [4, 0, 4, 8]]",73160,right,8,"[[0, 0, 0, 16], [0, 4, 2, 256], [0, 0, 512, 16], [4, 0, 8, 8]]",73168
5,"[[0, 0, 0, 16], [0, 4, 2, 256], [0, 0, 512, 16], [4, 0, 8, 8]]",73168,right,16,"[[0, 0, 0, 16], [0, 4, 2, 256], [0, 4, 512, 16], [0, 0, 4, 16]]",73184
5,"[[0, 0, 0, 16], [0, 4, 2, 256], [0, 4, 512, 16], [0, 0, 4, 16]]",73184,down,40,"[[0, 0, 0, 4], [0, 0, 2, 16], [0, 0, 512, 256], [0, 8, 4, 32]]",73224
5,"[[0, 0, 0, 4], [0, 0, 2, 16], [0, 0, 512, 256], [0, 8, 4, 32]]",73224,down,0,"[[0, 0, 0, 4], [0, 2, 2, 16], [0, 0, 512, 256], [0, 8, 4, 32]]",73224
5,"[[0, 0, 0, 4], [0, 2, 2, 16], [0, 0, 512, 256], [0, 8, 4, 32]]",73224,right,4,"[[0, 4, 0, 4], [0, 0, 4, 16], [0, 0, 512, 256], [0, 8, 4, 32]]",73228
5,"[[0, 4, 0, 4], [0, 0, 4, 16], [0, 0, 512, 256], [0, 8, 4, 32]]",73228,up,0,"[[0, 4, 4, 4], [0, 8, 512, 16], [0, 0, 4, 256], [0, 2, 0, 32]]",73228
5,"[[0, 4, 4, 4], [0, 8, 512, 16], [0, 0, 4, 256], [0, 2, 0, 32]]",73228,left,8,"[[8, 4, 0, 0], [8, 512, 16, 0], [4, 256, 0, 0], [2, 32, 4, 0]]",73236
5,"[[8, 4, 0, 0], [8, 512, 16, 0], [4, 256, 0, 0], [2, 32, 4, 0]]",73236,down,16,"[[0, 4, 2, 0], [16, 512, 0, 0], [4, 256, 16, 0], [2, 32, 4, 0]]",73252
5,"[[0, 4, 2, 0], [16, 512, 0, 0], [4, 256, 16, 0], [2, 32, 4, 0]]",73252,right,0,"[[2, 0, 4, 2], [0, 0, 16, 512], [0, 4, 256, 16], [0, 2, 32, 4]]",73252
5,"[[2, 0, 4, 2], [0, 0, 16, 512], [0, 4, 256, 16], [0, 2, 32, 4]]",73252,up,0,"[[2, 4, 4, 2], [2, 2, 16, 512], [0, 0, 256, 16], [0, 0, 32, 4]]",73252
5,"[[2, 4, 4, 2], [2, 2, 16, 512], [0, 0, 256, 16], [0, 0, 32, 4]]",73252,left,12,"[[2, 8, 2, 0], [4, 16, 512, 4], [256, 16, 0, 0], [32, 4, 0, 0]]",73264
5,"[[2, 8, 2, 0], [4, 16, 512, 4], [256, 16, 0, 0], [32, 4, 0, 0]]",73264,down,32,"[[2, 0, 0, 2], [4, 8, 0, 0], [256, 32, 2, 0], [32, 4, 512, 4]]",73296
5,"[[2, 0, 0, 2], [4, 8, 0, 0], [256, 32, 2, 0], [32, 4, 512, 4]]",73296,left,4,"[[4, 2, 0, 0], [4, 8, 0, 0], [256, 32, 2, 0], [32, 4, 512, 4]]",73300
5,"[[4, 2, 0, 0], [4, 8, 0, 0], [256, 32, 2, 0], [32, 4, 512, 4]]",73300,up,8,"[[8, 2, 2, 4], [256, 8, 512, 4], [32, 32, 0, 0], [0, 4, 0, 0]]",73308
5,"[[8, 2, 2, 4], [256, 8, 512, 4], [32, 32, 0, 0], [0, 4, 0, 0]]",73308,right,68,"[[0, 8, 4, 4], [256, 8, 512, 4], [0, 0, 0, 64], [0, 0, 2, 4]]",73376
5,"[[0, 8, 4, 4], [256, 8, 512, 4], [0, 0, 0, 64], [0, 0, 2, 4]]",73376,up,24,"[[256, 16, 4, 8], [0, 0, 512, 64], [0, 2, 2, 4], [0, 0, 0, 0]]",73400
5,"[[256, 16, 4, 8], [0, 0, 512, 64], [0, 2, 2, 4], [0, 0, 0, 0]]",73400,left,4,"[[256, 16, 4, 8], [512, 64, 0, 0], [4, 4, 0, 0], [2, 0, 0, 0]]",73404
5,"[[256, 16, 4, 8], [512, 64, 0, 0], [4, 4, 0, 0], [2, 0, 0, 0]]",73404,down,0,"[[256, 0, 0, 0], [512, 16, 0, 0], [4, 64, 2, 0], [2, 4, 4, 8]]",73404
5,"[[256, 0, 0, 0], [512, 16, 0, 0], [4, 64, 2, 0], [2, 4, 4, 8]]",73404,right,8,"[[2, 0, 0, 256], [0, 0, 512, 16], [0, 4, 64, 2], [0, 2, 8, 8]]",73412
5,"[[2, 0, 0, 256], [0, 0, 512, 16], [0, 4, 64, 2], [0, 2, 8, 8]]",73412,right,16,"[[0, 0, 2, 256], [0, 2, 512, 16], [0, 4, 64, 2], [0, 0, 2, 16]]",73428
5,"[[0, 0, 2, 256], [0, 2, 512, 16], [0, 4, 64, 2], [0, 0, 2, 16]]",73428,up,0,"[[4, 2, 2, 256], [0, 4, 512, 16], [0, 0, 64, 2], [0, 0, 2, 16]]",73428
5,"[[4, 2, 2, 256], [0, 4, 512, 16], [0, 0, 64, 2], [0, 0, 2, 16]]",73428,left,4,"[[4, 4, 256, 0], [4, 512, 16, 0], [64, 2, 0, 0], [2, 16, 0, 4]]",73432
5,"[[4, 4, 256, 0], [4, 512, 16, 0], [64, 2, 0, 0], [2, 16, 0, 4]]",73432,down,8,"[[0, 4, 4, 0], [8, 512, 0, 0], [64, 2, 256, 0], [2, 16, 16, 4]]",73440
5,"[[0, 4, 4, 0], [8, 512, 0, 0], [64, 2, 256, 0], [2, 16, 16, 4]]",73440,left,40,"[[8, 0, 0, 0], [8, 512, 0, 0], [64, 2, 256, 0], [2, 32, 4, 4]]",73480
5,"[[8, 0, 0, 0], [8, 512, 0, 0], [64, 2, 256, 0], [2, 32, 4, 4]]",73480,up,16,"[[16, 512, 256, 4], [64, 2, 4, 0], [2, 32, 0, 4], [0, 0, 0, 0]]",73496
5,"[[16, 512, 256, 4], [64, 2, 4, 0], [2, 32, 0, 4], [0, 0, 0, 0]]",73496,up,8,"[[16, 512, 256, 8], [64, 2, 4, 0], [2, 32, 0, 0], [0, 0, 4, 0]]",73504
5,"[[16, 512, 256, 8], [64, 2, 4, 0], [2, 32, 0, 0], [0, 0, 4, 0]]",73504,down,8,"[[0, 0, 0, 0], [16, 512, 0, 0], [64, 2, 256, 4], [2, 32, 8, 8]]",73512
5,"[[0, 0, 0, 0], [16, 512, 0, 0], [64, 2, 256, 4], [2, 32, 8, 8]]",73512,right,16,"[[0, 0, 0, 4], [0, 0, 16, 512], [64, 2, 256, 4], [0, 2, 32, 16]]",73528
5,"[[0, 0, 0, 4], [0, 0, 16, 512], [64, 2, 256, 4], [0, 2, 32, 16]]",73528,down,4,"[[0, 0, 4, 4], [0, 0, 16, 512], [0, 0, 256, 4], [64, 4, 32, 16]]",73532
5,"[[0, 0, 4, 4], [0, 0, 16, 512], [0, 0, 256, 4], [64, 4, 32, 16]]",73532,left,8,"[[8, 2, 0, 0], [16, 512, 0, 0], [256, 4, 0, 0], [64, 4, 32, 16]]",73540
5,"[[8, 2, 0, 0], [16, 512, 0, 0], [256, 4, 0, 0], [64, 4, 32, 16]]",73540,down,8,"[[8, 0, 0, 0], [16, 2, 2, 0], [256, 512, 0, 0], [64, 8, 32, 16]]",73548
5,"[[8, 0, 0, 0], [16, 2, 2, 0], [256, 512, 0, 0], [64, 8, 32, 16]]",73548,left,4,"[[8, 0, 0, 0], [16, 4, 0, 0], [256, 512, 4, 0], [64, 8, 32, 16]]",73552
5,"[[8, 0, 0, 0], [16, 4, 0, 0], [256, 512, 4, 0], [64, 8, 32, 16]]",73552,up,0,"[[8, 4, 4, 16], [16, 512, 32, 0], [256, 8, 0, 0], [64, 0, 2, 0]]",73552
5,"[[8, 4, 4, 16], [16, 512, 32, 0], [256, 8, 0, 0], [64, 0, 2, 0]]",73552,left,8,"[[8, 8, 16, 0], [16, 512, 32, 0], [256, 8, 0, 0], [64, 2, 0, 4]]",73560
5,"[[8, 8, 16, 0], [16, 512, 32, 0], [256, 8, 0, 0], [64, 2, 0, 4]]",73560,right,16,"[[4, 0, 16, 16], [0, 16, 512, 32], [0, 0, 256, 8], [0, 64, 2, 4]]",73576
5,"[[4, 0, 16, 16], [0, 16, 512, 32], [0, 0, 256, 8], [0, 64, 2, 4]]",73576,right,32,"[[2, 0, 4, 32], [0, 16, 512, 32], [0, 0, 256, 8], [0, 64, 2, 4]]",73608
5,"[[2, 0, 4, 32], [0, 16, 512, 32], [0, 0, 256, 8], [0, 64, 2, 4]]",73608,up,64,"[[2, 16, 4, 64], [0, 64, 512, 8], [0, 0, 256, 4], [0, 4, 2, 0]]",73672
5,"[[2, 16, 4, 64], [0, 64, 512, 8], [0, 0, 256, 4], [0, 4, 2, 0]]",73672,left,0,"[[2, 16, 4, 64], [64, 512, 8, 4], [256, 4, 0, 0], [4, 2, 0, 0]]",73672
5,"[[2, 16, 4, 64], [64, 512, 8, 4], [256, 4, 0, 0], [4, 2, 0, 0]]",73672,down,0,"[[2, 16, 2, 0], [64, 512, 0, 0], [256, 4, 4, 64], [4, 2, 8, 4]]",73672
5,"[[2, 16, 2, 0], [64, 512, 0, 0], [256, 4, 4, 64], [4, 2, 8, 4]]",73672,right,8,"[[0, 2, 16, 2], [0, 4, 64, 512], [0, 256, 8, 64], [4, 2, 8, 4]]",73680
5,"[[0, 2, 16, 2], [0, 4, 64, 512], [0, 256, 8, 64], [4, 2, 8, 4]]",73680,down,16,"[[0, 2, 0, 2], [0, 4, 16, 512], [4, 256, 64, 64], [4, 2, 16, 4]]",73696
5,"[[0, 2, 0, 2], [0, 4, 16, 512], [4, 256, 64, 64], [4, 2, 16, 4]]",73696,left,132,"[[4, 0, 0, 0], [4, 16, 512, 4], [4, 256, 128, 0], [4, 2, 16, 4]]",73828
5,"[[4, 0, 0, 0], [4, 16, 512, 4], [4, 256, 128, 0], [4, 2, 16, 4]]",73828,up,24,"[[8, 16, 512, 8], [8, 256, 128, 0], [2, 2, 16, 0], [0, 0, 0, 0]]",73852
5,"[[8, 16, 512, 8], [8, 256, 128, 0], [2, 2, 16, 0], [0, 0, 0, 0]]",73852,up,16,"[[16, 16, 512, 8], [2, 256, 128, 0], [0, 2, 16, 0], [0, 0, 0, 2]]",73868
5,"[[16, 16, 512, 8], [2, 256, 128, 0], [0, 2, 16, 0], [0, 0, 0, 2]]",73868,left,32,"[[32, 512, 8, 0], [2, 256, 128, 2], [2, 16, 0, 0], [2, 0, 0, 0]]",73900
5,"[[32, 512, 8, 0], [2, 256, 128, 2], [2, 16, 0, 0], [2, 0, 0, 0]]",73900,down,4,"[[0, 0, 0, 0], [32, 512, 0, 4], [2, 256, 8, 0], [4, 16, 128, 2]]",73904
5,"[[0, 0, 0, 0], [32, 512, 0, 4], [2, 256, 8, 0], [4, 16, 128, 2]]",73904,left,0,"[[0, 2, 0, 0], [32, 512, 4, 0], [2, 256, 8, 0], [4, 16, 128, 2]]",73904
5,"[[0, 2, 0, 0], [32, 512, 4, 0], [2, 256, 8, 0], [4, 16, 128, 2]]",73904,down,0,"[[0, 2, 0, 4], [32, 512, 4, 0], [2, 256, 8, 0], [4, 16, 128, 2]]",73904
5,"[[0, 2, 0, 4], [32, 512, 4, 0], [2, 256, 8, 0], [4, 16, 128, 2]]",73904,right,0,"[[0, 0, 2, 4], [2, 32, 512, 4], [0, 2, 256, 8], [4, 16, 128, 2]]",73904
5,"[[0, 0, 2, 4], [2, 32, 512, 4], [0, 2, 256, 8], [4, 16, 128, 2]]",73904,down,8,"[[0, 4, 2, 0], [0, 32, 512, 8], [2, 2, 256, 8], [4, 16, 128, 2]]",73912
5,"[[0, 4, 2, 0], [0, 32, 512, 8], [2, 2, 256, 8], [4, 16, 128, 2]]",73912,down,16,"[[0, 4, 2, 0], [0, 32, 512, 4], [2, 2, 256, 16], [4, 16, 128, 2]]",73928
5,"[[0, 4, 2, 0], [0, 32, 512, 4], [2, 2, 256, 16], [4, 16, 128, 2]]",73928,left,4,"[[4, 2, 0, 0], [32, 512, 4, 4], [4, 256, 16, 0], [4, 16, 128, 2]]",73932
5,"[[4, 2, 0, 0], [32, 512, 4, 4], [4, 256, 16, 0], [4, 16, 128, 2]]",73932,left,8,"[[4, 2, 4, 0], [32, 512, 8, 0], [4, 256, 16, 0], [4, 16, 128, 2]]",73940
5,"[[4, 2, 4, 0], [32, 512, 8, 0], [4, 256, 16, 0], [4, 16, 128, 2]]",73940,down,8,"[[0, 2, 4, 0], [4, 512, 8, 0], [32, 256, 16, 4], [8, 16, 128, 2]]",73948
5,"[[0, 2, 4, 0], [4, 512, 8, 0], [32, 256, 16, 4], [8, 16, 128, 2]]",73948,up,0,"[[4, 2, 4, 4], [32, 512, 8, 2], [8, 256, 16, 0], [2, 16, 128, 0]]",73948
5,"[[4, 2, 4, 4], [32, 512, 8, 2], [8, 256, 16, 0], [2, 16, 128, 0]]",73948,left,8,"[[4, 2, 8, 2], [32, 512, 8, 2], [8, 256, 16, 0], [2, 16, 128, 0]]",73956
5,"[[4, 2, 8, 2], [32, 512, 8, 2], [8, 256, 16, 0], [2, 16, 128, 0]]",73956,down,20,"[[4, 2, 0, 0], [32, 512, 16, 2], [8, 256, 16, 0], [2, 16, 128, 4]]",73976
5,"[[4, 2, 0, 0], [32, 512, 16, 2], [8, 256, 16, 0], [2, 16, 128, 4]]",73976,down,32,"[[4, 2, 4, 0], [32, 512, 0, 0], [8, 256, 32, 2], [2, 16, 128, 4]]",74008
5,"[[4, 2, 4, 0], [32, 512, 0, 0], [8, 256, 32, 2], [2, 16, 128, 4]]",74008,right,0,"[[4, 4, 2, 4], [0, 0, 32, 512], [8, 256, 32, 2], [2, 16, 128, 4]]",74008
5,"[[4, 4, 2, 4], [0, 0, 32, 512], [8, 256, 32, 2], [2, 16, 128, 4]]",74008,down,64,"[[0, 4, 0, 4], [4, 4, 2, 512], [8, 256, 64, 2], [2, 16, 128, 4]]",74072
5,"[[0, 4, 0, 4], [4, 4, 2, 512], [8, 256, 64, 2], [2, 16, 128, 4]]",74072,left,16,"[[8, 0, 4, 0], [8, 2, 512, 0], [8, 256, 64, 2], [2, 16, 128, 4]]",74088
5,"[[8, 0, 4, 0], [8, 2, 512, 0], [8, 256, 64, 2], [2, 16, 128, 4]]",74088,down,16,"[[0, 4, 4, 0], [8, 2, 512, 0], [16, 256, 64, 2], [2, 16, 128, 4]]",74104
5,"[[0, 4, 4, 0], [8, 2, 512, 0], [16, 256, 64, 2], [2, 16, 128, 4]]",74104,left,8,"[[8, 0, 0, 2], [8, 2, 512, 0], [16, 256, 64, 2], [2, 16, 128, 4]]",74112
5,"[[8, 0, 0, 2], [8, 2, 512, 0], [16, 256, 64, 2], [2, 16, 128, 4]]",74112,up,20,"[[16, 2, 512, 4], [16, 256, 64, 4], [2, 16, 128, 0], [0, 2, 0, 0]]",74132
5,"[[16, 2, 512, 4], [16, 256, 64, 4], [2, 16, 128, 0], [0, 2, 0, 0]]",74132,down,40,"[[0, 2, 0, 0], [0, 256, 512, 0], [32, 16, 64, 2], [2, 2, 128, 8]]",74172
5,"[[0, 2, 0, 0], [0, 256, 512, 0], [32, 16, 64, 2], [2, 2, 128, 8]]",74172,left,4,"[[2, 0, 0, 0], [256, 512, 0, 2], [32, 16, 64, 2], [4, 128, 8, 0]]",74176
5,"[[2, 0, 0, 0], [256, 512, 0, 2], [32, 16, 64, 2], [4, 128, 8, 0]]",74176,down,4,"[[2, 0, 0, 4], [256, 512, 0, 0], [32, 16, 64, 0], [4, 128, 8, 4]]",74180
5,"[[2, 0, 0, 4], [256, 512, 0, 0], [32, 16, 64, 0], [4, 128, 8, 4]]",74180,down,8,"[[2, 0, 0, 0], [256, 512, 0, 4], [32, 16, 64, 0], [4, 128, 8, 8]]",74188
5,"[[2, 0, 0, 0], [256, 512, 0, 4], [32, 16, 64, 0], [4, 128, 8, 8]]",74188,up,0,"[[2, 512, 64, 4], [256, 16, 8, 8], [32, 128, 2, 0], [4, 0, 0, 0]]",74188
5,"[[2, 512, 64, 4], [256, 16, 8, 8], [32, 128, 2, 0], [4, 0, 0, 0]]",74188,right,16,"[[2, 512, 64, 4], [0, 256, 16, 16], [2, 32, 128, 2], [0, 0, 0, 4]]",74204
5,"[[2, 512, 64, 4], [0, 256, 16, 16], [2, 32, 128, 2], [0, 0, 0, 4]]",74204,left,32,"[[2, 512, 64, 4], [256, 32, 0, 2], [2, 32, 128, 2], [4, 0, 0, 0]]",74236
5,"[[2, 512, 64, 4], [256, 32, 0, 2], [2, 32, 128, 2], [4, 0, 0, 0]]",74236,up,68,"[[2, 512, 64, 4], [256, 64, 128, 4], [2, 0, 0, 0], [4, 0, 2, 0]]",74304
5,"[[2, 512, 64, 4], [256, 64, 128, 4], [2, 0, 0, 0], [4, 0, 2, 0]]",74304,left,0,"[[2, 512, 64, 4], [256, 64, 128, 4], [2, 0, 0, 0], [4, 2, 0, 2]]",74304
5,"[[2, 512, 64, 4], [256, 64, 128, 4], [2, 0, 0, 0], [4, 2, 0, 2]]",74304,down,8,"[[2, 0, 0, 0], [256, 512, 2, 0], [2, 64, 64, 8], [4, 2, 128, 2]]",74312
5,"[[2, 0, 0, 0], [256, 512, 2, 0], [2, 64, 64, 8], [4, 2, 128, 2]]",74312,right,128,"[[0, 0, 4, 2], [0, 256, 512, 2], [0, 2, 128, 8], [4, 2, 128, 2]]",74440
5,"[[0, 0, 4, 2], [0, 256, 512, 2], [0, 2, 128, 8], [4, 2, 128, 2]]",74440,down,264,"[[0, 0, 0, 0], [2, 0, 4, 4], [0, 256, 512, 8], [4, 4, 256, 2]]",74704
5,"[[0, 0, 0, 0], [2, 0, 4, 4], [0, 256, 512, 8], [4, 4, 256, 2]]",74704,down,0,"[[0, 0, 0, 0], [0, 2, 4, 4], [2, 256, 512, 8], [4, 4, 256, 2]]",74704
5,"[[0, 0, 0, 0], [0, 2, 4, 4], [2, 256, 512, 8], [4, 4, 256, 2]]",74704,left,16,"[[0, 0, 0, 0], [2, 8, 2, 0], [2, 256, 512, 8], [8, 256, 2, 0]]",74720
5,"[[0, 0, 0, 0], [2, 8, 2, 0], [2, 256, 512, 8], [8, 256, 2, 0]]",74720,down,516,"[[0, 0, 0, 0], [2, 0, 2, 0], [4, 8, 512, 0], [8, 512, 2, 8]]",75236
5,"[[0, 0, 0, 0], [2, 0, 2, 0], [4, 8, 512, 0], [8, 512, 2, 8]]",75236,up,0,"[[2, 8, 2, 8], [4, 512, 512, 0], [8, 4, 2, 0], [0, 0, 0, 0]]",75236
5,"[[2, 8, 2, 8], [4, 512, 512, 0], [8, 4, 2, 0], [0, 0, 0, 0]]",75236,right,1024,"[[2, 8, 2, 8], [0, 0, 4, 1024], [0, 8, 4, 2], [0, 0, 4, 0]]",76260
5,"[[2, 8, 2, 8], [0, 0, 4, 1024], [0, 8, 4, 2], [0, 0, 4, 0]]",76260,up,24,"[[2, 16, 2, 8], [2, 0, 8, 1024], [0, 0, 4, 2], [0, 0, 0, 0]]",76284
5,"[[2, 16, 2, 8], [2, 0, 8, 1024], [0, 0, 4, 2], [0, 0, 0, 0]]",76284,up,4,"[[4, 16, 2, 8], [2, 0, 8, 1024], [0, 0, 4, 2], [0, 0, 0, 0]]",76288
5,"[[4, 16, 2, 8], [2, 0, 8, 1024], [0, 0, 4, 2], [0, 0, 0, 0]]",76288,down,0,"[[0, 0, 0, 0], [2, 0, 2, 8], [4, 0, 8, 1024], [2, 16, 4, 2]]",76288
5,"[[0, 0, 0, 0], [2, 0, 2, 8], [4, 0, 8, 1024], [2, 16, 4, 2]]",76288,left,4,"[[0, 0, 0, 0], [4, 8, 0, 0], [4, 8, 1024, 4], [2, 16, 4, 2]]",76292
5,"[[0, 0, 0, 0], [4, 8, 0, 0], [4, 8, 1024, 4], [2, 16, 4, 2]]",76292,up,24,"[[8, 16, 1024, 4], [2, 16, 4, 2], [0, 0, 0, 0], [4, 0, 0, 0]]",76316
5,"[[8, 16, 1024, 4], [2, 16, 4, 2], [0, 0, 0, 0], [4, 0, 0, 0]]",76316,up,32,"[[8, 32, 1024, 4], [2, 0, 4, 2], [4, 0, 0, 0], [0, 4, 0, 0]]",76348
5,"[[8, 32, 1024, 4], [2, 0, 4, 2], [4, 0, 0, 0], [0, 4, 0, 0]]",76348,right,0,"[[8, 32, 1024, 4], [0, 2, 4, 2], [2, 0, 0, 4], [0, 0, 0, 4]]",76348
5,"[[8, 32, 1024, 4], [0, 2, 4, 2], [2, 0, 0, 4], [0, 0, 0, 4]]",76348,down,8,"[[4, 0, 0, 0], [0, 0, 0, 4], [8, 32, 1024, 2], [2, 2, 4, 8]]",76356
5,"[[4, 0, 0, 0], [0, 0, 0, 4], [8, 32, 1024, 2], [2, 2, 4, 8]]",76356,left,4,"[[4, 0, 0, 0], [4, 0, 0, 2], [8, 32, 1024, 2], [4, 4, 8, 0]]",76360
5,"[[4, 0, 0, 0], [4, 0, 0, 2], [8, 32, 1024, 2], [4, 4, 8, 0]]",76360,down,12,"[[0, 0, 0, 2], [8, 0, 0, 0], [8, 32, 1024, 0], [4, 4, 8, 4]]",76372
5,"[[0, 0, 0, 2], [8, 0, 0, 0], [8, 32, 1024, 0], [4, 4, 8, 4]]",76372,up,16,"[[16, 32, 1024, 2], [4, 4, 8, 4], [0, 0, 0, 2], [0, 0, 0, 0]]",76388
5,"[[16, 32, 1024, 2], [4, 4, 8, 4], [0, 0, 0, 2], [0, 0, 0, 0]]",76388,left,8,"[[16, 32, 1024, 2], [8, 8, 4, 4], [2, 0, 0, 0], [0, 0, 0, 0]]",76396
5,"[[16, 32, 1024, 2], [8, 8, 4, 4], [2, 0, 0, 0], [0, 0, 0, 0]]",76396,left,24,"[[16, 32, 1024, 2], [16, 8, 0, 0], [2, 0, 0, 0], [0, 0, 0, 4]]",76420
5,"[[16, 32, 1024, 2], [16, 8, 0, 0], [2, 0, 0, 0], [0, 0, 0, 4]]",76420,up,32,"[[32, 32, 1024, 2], [2, 8, 0, 4], [0, 0, 0, 0], [2, 0, 0, 0]]",76452
5,"[[32, 32, 1024, 2], [2, 8, 0, 4], [0, 0, 0, 0], [2, 0, 0, 0]]",76452,left,64,"[[64, 1024, 2, 0], [2, 8, 4, 0], [0, 0, 0, 0], [2, 2, 0, 0]]",76516
5,"[[64, 1024, 2, 0], [2, 8, 4, 0], [0, 0, 0, 0], [2, 2, 0, 0]]",76516,right,4,"[[0, 64, 1024, 2], [0, 2, 8, 4], [0, 0, 0, 0], [0, 0, 4, 4]]",76520
5,"[[0, 64, 1024, 2], [0, 2, 8, 4], [0, 0, 0, 0], [0, 0, 4, 4]]",76520,up,8,"[[0, 64, 1024, 2], [0, 2, 8, 8], [0, 0, 4, 0], [0, 0, 2, 0]]",76528
5,"[[0, 64, 1024, 2], [0, 2, 8, 8], [0, 0, 4, 0], [0, 0, 2, 0]]",76528,left,16,"[[64, 1024, 2, 0], [2, 16, 0, 2], [4, 0, 0, 0], [2, 0, 0, 0]]",76544
5,"[[64, 1024, 2, 0], [2, 16, 0, 2], [4, 0, 0, 0], [2, 0, 0, 0]]",76544,right,0,"[[0, 64, 1024, 2], [0, 2, 16, 2], [0, 0, 0, 4], [2, 0, 0, 2]]",76544
5,"[[0, 64, 1024, 2], [0, 2, 16, 2], [0, 0, 0, 4], [2, 0, 0, 2]]",76544,left,4,"[[64, 1024, 2, 0], [2, 16, 2, 0], [4, 0, 0, 0], [4, 4, 0, 0]]",76548
5,"[[64, 1024, 2, 0], [2, 16, 2, 0], [4, 0, 0, 0], [4, 4, 0, 0]]",76548,down,12,"[[0, 0, 0, 0], [64, 1024, 2, 0], [2, 16, 0, 0], [8, 4, 4, 0]]",76560
5,"[[0, 0, 0, 0], [64, 1024, 2, 0], [2, 16, 0, 0], [8, 4, 4, 0]]",76560,right,8,"[[0, 0, 2, 0], [0, 64, 1024, 2], [0, 0, 2, 16], [0, 0, 8, 8]]",76568
5,"[[0, 0, 2, 0], [0, 64, 1024, 2], [0, 0, 2, 16], [0, 0, 8, 8]]",76568,right,16,"[[0, 0, 0, 2], [0, 64, 1024, 2], [0, 0, 2, 16], [0, 0, 4, 16]]",76584
5,"[[0, 0, 0, 2], [0, 64, 1024, 2], [0, 0, 2, 16], [0, 0, 4, 16]]",76584,up,36,"[[0, 64, 1024, 4], [0, 0, 2, 32], [0, 0, 4, 0], [0, 4, 0, 0]]",76620
5,"[[0, 64, 1024, 4], [0, 0, 2, 32], [0, 0, 4, 0], [0, 4, 0, 0]]",76620,right,0,"[[0, 64, 1024, 4], [0, 0, 2, 32], [0, 2, 0, 4], [0, 0, 0, 4]]",76620
5,"[[0, 64, 1024, 4], [0, 0, 2, 32], [0, 2, 0, 4], [0, 0, 0, 4]]",76620,down,8,"[[0, 0, 0, 0], [0, 0, 0, 4], [0, 64, 1024, 32], [2, 2, 2, 8]]",76628
5,"[[0, 0, 0, 0], [0, 0, 0, 4], [0, 64, 1024, 32], [2, 2, 2, 8]]",76628,right,4,"[[0, 0, 0, 0], [0, 0, 0, 4], [2, 64, 1024, 32], [0, 2, 4, 8]]",76632
5,"[[0, 0, 0, 0], [0, 0, 0, 4], [2, 64, 1024, 32], [0, 2, 4, 8]]",76632,left,0,"[[0, 0, 0, 0], [4, 2, 0, 0], [2, 64, 1024, 32], [2, 4, 8, 0]]",76632
5,"[[0, 0, 0, 0], [4, 2, 0, 0], [2, 64, 1024, 32], [2, 4, 8, 0]]",76632,down,4,"[[0, 0, 4, 0], [0, 2, 0, 0], [4, 64, 1024, 0], [4, 4, 8, 32]]",76636
5,"[[0, 0, 4, 0], [0, 2, 0, 0], [4, 64, 1024, 0], [4, 4, 8, 32]]",76636,right,8,"[[0, 0, 0, 4], [0, 0, 2, 2], [0, 4, 64, 1024], [0, 8, 8, 32]]",76644
5,"[[0, 0, 0, 4], [0, 0, 2, 2], [0, 4, 64, 1024], [0, 8, 8, 32]]",76644,right,20,"[[0, 2, 0, 4], [0, 0, 0, 4], [0, 4, 64, 1024], [0, 0, 16, 32]]",76664
5,"[[0, 2, 0, 4], [0, 0, 0, 4], [0, 4, 64, 1024], [0, 0, 16, 32]]",76664,down,8,"[[0, 0, 0, 0], [0, 0, 0, 8], [0, 2, 64, 1024], [2, 4, 16, 32]]",76672
5,"[[0, 0, 0, 0], [0, 0, 0, 8], [0, 2, 64, 1024], [2, 4, 16, 32]]",76672,left,0,"[[0, 0, 0, 0], [8, 0, 4, 0], [2, 64, 1024, 0], [2, 4, 16, 32]]",76672
5,"[[0, 0, 0, 0], [8, 0, 4, 0], [2, 64, 1024, 0], [2, 4, 16, 32]]",76672,down,4,"[[0, 0, 0, 0], [0, 0, 4, 0], [8, 64, 1024, 2], [4, 4, 16, 32]]",76676
5,"[[0, 0, 0, 0], [0, 0, 4, 0], [8, 64, 1024, 2], [4, 4, 16, 32]]",76676,left,8,"[[2, 0, 0, 0], [4, 0, 0, 0], [8, 64, 1024, 2], [8, 16, 32, 0]]",76684
5,"[[2, 0, 0, 0], [4, 0, 0, 0], [8, 64, 1024, 2], [8, 16, 32, 0]]",76684,down,16,"[[0, 0, 2, 0], [2, 0, 0, 0], [4, 64, 1024, 0], [16, 16, 32, 2]]",76700
5,"[[0, 0, 2, 0], [2, 0, 0, 0], [4, 64, 1024, 0], [16, 16, 32, 2]]",76700,right,32,"[[0, 0, 0, 2], [0, 0, 0, 2], [0, 4, 64, 1024], [4, 32, 32, 2]]",76732
5,"[[0, 0, 0, 2], [0, 0, 0, 2], [0, 4, 64, 1024], [4, 32, 32, 2]]",76732,right,64,"[[0, 0, 0, 2], [0, 4, 0, 2], [0, 4, 64, 1024], [0, 4, 64, 2]]",76796
5,"[[0, 0, 0, 2], [0, 4, 0, 2], [0, 4, 64, 1024], [0, 4, 64, 2]]",76796,down,140,"[[0, 0, 0, 2], [0, 0, 0, 4], [0, 4, 0, 1024], [0, 8, 128, 2]]",76936
5,"[[0, 0, 0, 2], [0, 0, 0, 4], [0, 4, 0, 1024], [0, 8, 128, 2]]",76936,left,0,"[[2, 0, 0, 0], [4, 0, 2, 0], [4, 1024, 0, 0], [8, 128, 2, 0]]",76936
5,"[[2, 0, 0, 0], [4, 0, 2, 0], [4, 1024, 0, 0], [8, 128, 2, 0]]",76936,up,12,"[[2, 1024, 4, 0], [8, 128, 0, 4], [8, 0, 0, 0], [0, 0, 0, 0]]",76948
5,"[[2, 1024, 4, 0], [8, 128, 0, 4], [8, 0, 0, 0], [0, 0, 0, 0]]",76948,down,16,"[[0, 0, 0, 4], [0, 0, 0, 0], [2, 1024, 0, 0], [16, 128, 4, 4]]",76964
5,"[[0, 0, 0, 4], [0, 0, 0, 0], [2, 1024, 0, 0], [16, 128, 4, 4]]",76964,down,8,"[[0, 0, 0, 0], [0, 0, 0, 0], [2, 1024, 0, 4], [16, 128, 4, 8]]",76972
5,"[[0, 0, 0, 0], [0, 0, 0, 0], [2, 1024, 0, 4], [16, 128, 4, 8]]",76972,up,0,"[[2, 1024, 4, 4], [16, 128, 0, 8], [0, 0, 0, 0], [0, 0, 0, 4]]",76972
5,"[[2, 1024, 4, 4], [16, 128, 0, 8], [0, 0, 0, 0], [0, 0, 0, 4]]",76972,left,8,"[[2, 1024, 8, 0], [16, 128, 8, 0], [0, 0, 0, 0], [4, 2, 0, 0]]",76980
5,"[[2, 1024, 8, 0], [16, 128, 8, 0], [0, 0, 0, 0], [4, 2, 0, 0]]",76980,up,16,"[[2, 1024, 16, 0], [16, 128, 0, 0], [4, 2, 0, 0], [0, 0, 2, 0]]",76996
5,"[[2, 1024, 16, 0], [16, 128, 0, 0], [4, 2, 0, 0], [0, 0, 2, 0]]",76996,right,0,"[[4, 2, 1024, 16], [0, 0, 16, 128], [0, 0, 4, 2], [0, 0, 0, 2]]",76996
5,"[[4, 2, 1024, 16], [0, 0, 16, 128], [0, 0, 4, 2], [0, 0, 0, 2]]",76996,down,4,"[[2, 0, 0, 0], [0, 0, 1024, 16], [0, 0, 16, 128], [4, 2, 4, 4]]",77000
5,"[[2, 0, 0, 0], [0, 0, 1024, 16], [0, 0, 16, 128], [4, 2, 4, 4]]",77000,right,8,"[[0, 0, 0, 2], [0, 0, 1024, 16], [2, 0, 16, 128], [0, 4, 2, 8]]",77008
5,"[[0, 0, 0, 2], [0, 0, 1024, 16], [2, 0, 16, 128], [0, 4, 2, 8]]",77008,up,0,"[[2, 4, 1024, 2], [0, 0, 16, 16], [0, 0, 2, 128], [0, 4, 0, 8]]",77008
5,"[[2, 4, 1024, 2], [0, 0, 16, 16], [0, 0, 2, 128], [0, 4, 0, 8]]",77008,right,32,"[[2, 4, 1024, 2], [0, 0, 0, 32], [0, 0, 2, 128], [0, 2, 4, 8]]",77040
5,"[[2, 4, 1024, 2], [0, 0, 0, 32], [0, 0, 2, 128], [0, 2, 4, 8]]",77040,up,0,"[[2, 4, 1024, 2], [0, 2, 2, 32], [0, 2, 4, 128], [0, 0, 0, 8]]",77040
5,"[[2, 4, 1024, 2], [0, 2, 2, 32], [0, 2, 4, 128], [0, 0, 0, 8]]",77040,down,4,"[[0, 0, 0, 2], [4, 0, 1024, 32], [0, 4, 2, 128], [2, 4, 4, 8]]",77044
5,"[[0, 0, 0, 2], [4, 0, 1024, 32], [0, 4, 2, 128], [2, 4, 4, 8]]",77044,left,8,"[[2, 0, 0, 0], [4, 1024, 32, 0], [4, 2, 128, 0], [2, 8, 8, 2]]",77052
5,"[[2, 0, 0, 0], [4, 1024, 32, 0], [4, 2, 128, 0], [2, 8, 8, 2]]",77052,right,16,"[[0, 0, 0, 2], [0, 4, 1024, 32], [2, 4, 2, 128], [0, 2, 16, 2]]",77068
5,"[[0, 0, 0, 2], [0, 4, 1024, 32], [2, 4, 2, 128], [0, 2, 16, 2]]",77068,up,8,"[[2, 8, 1024, 2], [0, 2, 2, 32], [0, 4, 16, 128], [0, 0, 0, 2]]",77076
5,"[[2, 8, 1024, 2], [0, 2, 2, 32], [0, 4, 16, 128], [0, 0, 0, 2]]",77076,right,4,"[[2, 8, 1024, 2], [0, 0, 4, 32], [0, 4, 16, 128], [0, 0, 2, 2]]",77080
5,"[[2, 8, 1024, 2], [0, 0, 4, 32], [0, 4, 16, 128], [0, 0, 2, 2]]",77080,up,0,"[[2, 8, 1024, 2], [0, 4, 4, 32], [0, 0, 16, 128], [4, 0, 2, 2]]",77080
5,"[[2, 8, 1024, 2], [0, 4, 4, 32], [0, 0, 16, 128], [4, 0, 2, 2]]",77080,left,12,"[[2, 8, 1024, 2], [8, 32, 0, 0], [16, 128, 2, 0], [4, 4, 0, 0]]",77092
5,"[[2, 8, 1024, 2], [8, 32, 0, 0], [16, 128, 2, 0], [4, 4, 0, 0]]",77092,left,8,"[[2, 8, 1024, 2], [8, 32, 0, 0], [16, 128, 2, 2], [8, 0, 0, 0]]",77100
5,"[[2, 8, 1024, 2], [8, 32, 0, 0], [16, 128, 2, 2], [8, 0, 0, 0]]",77100,down,4,"[[2, 0, 0, 2], [8, 8, 0, 0], [16, 32, 1024, 0], [8, 128, 2, 4]]",77104
5,"[[2, 0, 0, 2], [8, 8, 0, 0], [16, 32, 1024, 0], [8, 128, 2, 4]]",77104,left,20,"[[4, 0, 0, 0], [16, 0, 0, 4], [16, 32, 1024, 0], [8, 128, 2, 4]]",77124
5,"[[4, 0, 0, 0], [16, 0, 0, 4], [16, 32, 1024, 0], [8, 128, 2, 4]]",77124,down,40,"[[0, 0, 0, 0], [4, 0, 0, 2], [32, 32, 1024, 0], [8, 128, 2, 8]]",77164
5,"[[0, 0, 0, 0], [4, 0, 0, 2], [32, 32, 1024, 0], [8, 128, 2, 8]]",77164,left,64,"[[0, 0, 2, 0], [4, 2, 0, 0], [64, 1024, 0, 0], [8, 128, 2, 8]]",77228
5,"[[0, 0, 2, 0], [4, 2, 0, 0], [64, 1024, 0, 0], [8, 128, 2, 8]]",77228,down,4,"[[0, 0, 0, 0], [4, 2, 4, 0], [64, 1024, 0, 0], [8, 128, 4, 8]]",77232
5,"[[0, 0, 0, 0], [4, 2, 4, 0], [64, 1024, 0, 0], [8, 128, 4, 8]]",77232,down,8,"[[0, 0, 0, 0], [4, 2, 0, 0], [64, 1024, 0, 4], [8, 128, 8, 8]]",77240
5,"[[0, 0, 0, 0], [4, 2, 0, 0], [64, 1024, 0, 4], [8, 128, 8, 8]]",77240,left,16,"[[0, 0, 0, 2], [4, 2, 0, 0], [64, 1024, 4, 0], [8, 128, 16, 0]]",77256
5,"[[0, 0, 0, 2], [4, 2, 0, 0], [64, 1024, 4, 0], [8, 128, 16, 0]]",77256,right,0,"[[0, 0, 0, 2], [0, 0, 4, 2], [0, 64, 1024, 4], [2, 8, 128, 16]]",77256
5,"[[0, 0, 0, 2], [0, 0, 4, 2], [0, 64, 1024, 4], [2, 8, 128, 16]]",77256,down,4,"[[0, 0, 4, 0], [0, 0, 4, 4], [0, 64, 1024, 4], [2, 8, 128, 16]]",77260
5,"[[0, 0, 4, 0], [0, 0, 4, 4], [0, 64, 1024, 4], [2, 8, 128, 16]]",77260,up,16,"[[2, 64, 8, 8], [0, 8, 1024, 16], [0, 0, 128, 0], [0, 0, 0, 2]]",77276
5,"[[2, 64, 8, 8], [0, 8, 1024, 16], [0, 0, 128, 0], [0, 0, 0, 2]]",77276,left,16,"[[2, 64, 16, 0], [8, 1024, 16, 0], [128, 0, 0, 0], [2, 2, 0, 0]]",77292
5,"[[2, 64, 16, 0], [8, 1024, 16, 0], [128, 0, 0, 0], [2, 2, 0, 0]]",77292,down,32,"[[2, 0, 0, 0], [8, 64, 0, 4], [128, 1024, 0, 0], [2, 2, 32, 0]]",77324
5,"[[2, 0, 0, 0], [8, 64, 0, 4], [128, 1024, 0, 0], [2, 2, 32, 0]]",77324,right,4,"[[0, 0, 0, 2], [2, 8, 64, 4], [0, 0, 128, 1024], [0, 0, 4, 32]]",77328
5,"[[0, 0, 0, 2], [2, 8, 64, 4], [0, 0, 128, 1024], [0, 0, 4, 32]]",77328,left,0,"[[2, 0, 4, 0], [2, 8, 64, 4], [128, 1024, 0, 0], [4, 32, 0, 0]]",77328
5,"[[2, 0, 4, 0], [2, 8, 64, 4], [128, 1024, 0, 0], [4, 32, 0, 0]]",77328,up,4,"[[4, 8, 4, 4], [128, 1024, 64, 0], [4, 32, 0, 0], [0, 2, 0, 0]]",77332
5,"[[4, 8, 4, 4], [128, 1024, 64, 0], [4, 32, 0, 0], [0, 2, 0, 0]]",77332,right,8,"[[0, 4, 8, 8], [2, 128, 1024, 64], [0, 0, 4, 32], [0, 0, 0, 2]]",77340
5,"[[0, 4, 8, 8], [2, 128, 1024, 64], [0, 0, 4, 32], [0, 0, 0, 2]]",77340,right,16,"[[0, 0, 4, 16], [2, 128, 1024, 64], [2, 0, 4, 32], [0, 0, 0, 2]]",77356
5,"[[0, 0, 4, 16], [2, 128, 1024, 64], [2, 0, 4, 32], [0, 0, 0, 2]]",77356,down,4,"[[0, 2, 0, 16], [0, 0, 4, 64], [0, 0, 1024, 32], [4, 128, 4, 2]]",77360
5,"[[0, 2, 0, 16], [0, 0, 4, 64], [0, 0, 1024, 32], [4, 128, 4, 2]]",77360,down,0,"[[0, 0, 0, 16], [0, 0, 4, 64], [4, 2, 1024, 32], [4, 128, 4, 2]]",77360
5,"[[0, 0, 0, 16], [0, 0, 4, 64], [4, 2, 1024, 32], [4, 128, 4, 2]]",77360,down,8,"[[2, 0, 0, 16], [0, 0, 4, 64], [0, 2, 1024, 32], [8, 128, 4, 2]]",77368
5,"[[2, 0, 0, 16], [0, 0, 4, 64], [0, 2, 1024, 32], [8, 128, 4, 2]]",77368,up,0,"[[2, 2, 4, 16], [8, 128, 1024, 64], [0, 0, 4, 32], [4, 0, 0, 2]]",77368
5,"[[2, 2, 4, 16], [8, 128, 1024, 64], [0, 0, 4, 32], [4, 0, 0, 2]]",77368,left,4,"[[4, 4, 16, 0], [8, 128, 1024, 64], [4, 32, 0, 0], [4, 2, 0, 4]]",77372
5,"[[4, 4, 16, 0], [8, 128, 1024, 64], [4, 32, 0, 0], [4, 2, 0, 4]]",77372,left,8,"[[8, 16, 0, 0], [8, 128, 1024, 64], [4, 32, 2, 0], [4, 2, 4, 0]]",77380
5,"[[8, 16, 0, 0], [8, 128, 1024, 64], [4, 32, 2, 0], [4, 2, 4, 0]]",77380,up,24,"[[16, 16, 1024, 64], [8, 128, 2, 0], [0, 32, 4, 4], [0, 2, 0, 0]]",77404
5,"[[16, 16, 1024, 64], [8, 128, 2, 0], [0, 32, 4, 4], [0, 2, 0, 0]]",77404,left,40,"[[32, 1024, 64, 0], [8, 128, 2, 0], [32, 8, 4, 0], [2, 0, 0, 0]]",77444
5,"[[32, 1024, 64, 0], [8, 128, 2, 0], [32, 8, 4, 0], [2, 0, 0, 0]]",77444,up,0,"[[32, 1024, 64, 2], [8, 128, 2, 0], [32, 8, 4, 0], [2, 0, 0, 0]]",77444
5,"[[32, 1024, 64, 2], [8, 128, 2, 0], [32, 8, 4, 0], [2, 0, 0, 0]]",77444,right,0,"[[32, 1024, 64, 2], [0, 8, 128, 2], [0, 32, 8, 4], [0, 2, 0, 2]]",77444
5,"[[32, 1024, 64, 2], [0, 8, 128, 2], [0, 32, 8, 4], [0, 2, 0, 2]]",77444,down,4,"[[0, 1024, 4, 0], [0, 8, 64, 4], [0, 32, 128, 4], [32, 2, 8, 2]]",77448
5,"[[0, 1024, 4, 0], [0, 8, 64, 4], [0, 32, 128, 4], [32, 2, 8, 2]]",77448,right,0,"[[0, 4, 1024, 4], [0, 8, 64, 4], [0, 32, 128, 4], [32, 2, 8, 2]]",77448
5,"[[0, 4, 1024, 4], [0, 8, 64, 4], [0, 32, 128, 4], [32, 2, 8, 2]]",77448,left,0,"[[4, 1024, 4, 4], [8, 64, 4, 0], [32, 128, 4, 0], [32, 2, 8, 2]]",77448
5,"[[4, 1024, 4, 4], [8, 64, 4, 0], [32, 128, 4, 0], [32, 2, 8, 2]]",77448,up,72,"[[4, 1024, 8, 4], [8, 64, 4, 2], [64, 128, 8, 0], [2, 2, 0, 0]]",77520
5,"[[4, 1024, 8, 4], [8, 64, 4, 2], [64, 128, 8, 0], [2, 2, 0, 0]]",77520,right,4,"[[4, 1024, 8, 4], [8, 64, 4, 2], [4, 64, 128, 8], [0, 0, 0, 4]]",77524
5,"[[4, 1024, 8, 4], [8, 64, 4, 2], [4, 64, 128, 8], [0, 0, 0, 4]]",77524,down,128,"[[4, 0, 0, 4], [4, 0, 8, 2], [8, 1024, 4, 8], [4, 128, 128, 4]]",77652
5,"[[4, 0, 0, 4], [4, 0, 8, 2], [8, 1024, 4, 8], [4, 128, 128, 4]]",77652,left,264,"[[8, 0, 4, 0], [4, 8, 2, 0], [8, 1024, 4, 8], [4, 256, 4, 0]]",77916
5,"[[8, 0, 4, 0], [4, 8, 2, 0], [8, 1024, 4, 8], [4, 256, 4, 0]]",77916,up,8,"[[8, 8, 4, 8], [4, 1024, 2, 0], [8, 256, 8, 0], [4, 0, 0, 2]]",77924
5,"[[8, 8, 4, 8], [4, 1024, 2, 0], [8, 256, 8, 0], [4, 0, 0, 2]]",77924,right,16,"[[0, 16, 4, 8], [0, 4, 1024, 2], [0, 8, 256, 8], [4, 0, 4, 2]]",77940
5,"[[0, 16, 4, 8], [0, 4, 1024, 2], [0, 8, 256, 8], [4, 0, 4, 2]]",77940,left,8,"[[16, 4, 8, 0], [4, 1024, 2, 0], [8, 256, 8, 2], [8, 2, 0, 0]]",77948
5,"[[16, 4, 8, 0], [4, 1024, 2, 0], [8, 256, 8, 2], [8, 2, 0, 0]]",77948,up,16,"[[16, 4, 8, 2], [4, 1024, 2, 2], [16, 256, 8, 0], [0, 2, 0, 0]]",77964
5,"[[16, 4, 8, 2], [4, 1024, 2, 2], [16, 256, 8, 0], [0, 2, 0, 0]]",77964,right,4,"[[16, 4, 8, 2], [0, 4, 1024, 4], [0, 16, 256, 8], [0, 4, 0, 2]]",77968
5,"[[16, 4, 8, 2], [0, 4, 1024, 4], [0, 16, 256, 8], [0, 4, 0, 2]]",77968,up,8,"[[16, 8, 8, 2], [0, 16, 1024, 4], [0, 4, 256, 8], [0, 0, 4, 2]]",77976
5,"[[16, 8, 8, 2], [0, 16, 1024, 4], [0, 4, 256, 8], [0, 0, 4, 2]]",77976,left,16,"[[16, 16, 2, 0], [16, 1024, 4, 0], [4, 256, 8, 2], [4, 2, 0, 0]]",77992
5,"[[16, 16, 2, 0], [16, 1024, 4, 0], [4, 256, 8, 2], [4, 2, 0, 0]]",77992,up,40,"[[32, 16, 2, 2], [8, 1024, 4, 0], [0, 256, 8, 4], [0, 2, 0, 0]]",78032
5,"[[32, 16, 2, 2], [8, 1024, 4, 0], [0, 256, 8, 4], [0, 2, 0, 0]]",78032,left,4,"[[32, 16, 4, 4], [8, 1024, 4, 0], [256, 8, 4, 0], [2, 0, 0, 0]]",78036
5,"[[32, 16, 4, 4], [8, 1024, 4, 0], [256, 8, 4, 0], [2, 0, 0, 0]]",78036,right,8,"[[0, 32, 16, 8], [2, 8, 1024, 4], [0, 256, 8, 4], [0, 0, 0, 2]]",78044
5,"[[0, 32, 16, 8], [2, 8, 1024, 4], [0, 256, 8, 4], [0, 0, 0, 2]]",78044,left,0,"[[32, 16, 8, 0], [2, 8, 1024, 4], [256, 8, 4, 0], [2, 0, 0, 2]]",78044
5,"[[32, 16, 8, 0], [2, 8, 1024, 4], [256, 8, 4, 0], [2, 0, 0, 2]]",78044,up,16,"[[32, 16, 8, 4], [2, 16, 1024, 2], [256, 0, 4, 2], [2, 0, 0, 0]]",78060
5,"[[32, 16, 8, 4], [2, 16, 1024, 2], [256, 0, 4, 2], [2, 0, 0, 0]]",78060,up,36,"[[32, 32, 8, 4], [2, 0, 1024, 4], [256, 0, 4, 0], [2, 0, 4, 0]]",78096
5,"[[32, 32, 8, 4], [2, 0, 1024, 4], [256, 0, 4, 0], [2, 0, 4, 0]]",78096,right,64,"[[0, 64, 8, 4], [0, 2, 1024, 4], [4, 0, 256, 4], [0, 0, 2, 4]]",78160
5,"[[0, 64, 8, 4], [0, 2, 1024, 4], [4, 0, 256, 4], [0, 0, 2, 4]]",78160,down,16,"[[0, 0, 8, 0], [0, 4, 1024, 0], [0, 64, 256, 8], [4, 2, 2, 8]]",78176
5,"[[0, 0, 8, 0], [0, 4, 1024, 0], [0, 64, 256, 8], [4, 2, 2, 8]]",78176,up,16,"[[4, 4, 8, 16], [0, 64, 1024, 0], [0, 2, 256, 2], [0, 0, 2, 0]]",78192
5,"[[4, 4, 8, 16], [0, 64, 1024, 0], [0, 2, 256, 2], [0, 0, 2, 0]]",78192,left,8,"[[8, 8, 16, 0], [64, 1024, 4, 0], [2, 256, 2, 0], [2, 0, 0, 0]]",78200
5,"[[8, 8, 16, 0], [64, 1024, 4, 0], [2, 256, 2, 0], [2, 0, 0, 0]]",78200,left,16,"[[16, 16, 2, 0], [64, 1024, 4, 0], [2, 256, 2, 0], [2, 0, 0, 0]]",78216
5,"[[16, 16, 2, 0], [64, 1024, 4, 0], [2, 256, 2, 0], [2, 0, 0, 0]]",78216,left,32,"[[32, 2, 0, 0], [64, 1024, 4, 0], [2, 256, 2, 0], [2, 4, 0, 0]]",78248
5,"[[32, 2, 0, 0], [64, 1024, 4, 0], [2, 256, 2, 0], [2, 4, 0, 0]]",78248,down,4,"[[0, 2, 0, 0], [32, 1024, 4, 0], [64, 256, 4, 0], [4, 4, 2, 0]]",78252
5,"[[0, 2, 0, 0], [32, 1024, 4, 0], [64, 256, 4, 0], [4, 4, 2, 0]]",78252,left,8,"[[2, 0, 0, 0], [32, 1024, 4, 0], [64, 256, 4, 0], [8, 2, 2, 0]]",78260
5,"[[2, 0, 0, 0], [32, 1024, 4, 0], [64, 256, 4, 0], [8, 2, 2, 0]]",78260,right,4,"[[0, 0, 0, 2], [0, 32, 1024, 4], [0, 64, 256, 4], [4, 0, 8, 4]]",78264
5,"[[0, 0, 0, 2], [0, 32, 1024, 4], [0, 64, 256, 4], [4, 0, 8, 4]]",78264,down,8,"[[0, 0, 0, 0], [0, 0, 1024, 2], [2, 32, 256, 4], [4, 64, 8, 8]]",78272
5,"[[0, 0, 0, 0], [0, 0, 1024, 2], [2, 32, 256, 4], [4, 64, 8, 8]]",78272,left,16,"[[0, 0, 0, 0], [1024, 2, 0, 0], [2, 32, 256, 4], [4, 64, 16, 4]]",78288
5,"[[0, 0, 0, 0], [1024, 2, 0, 0], [2, 32, 256, 4], [4, 64, 16, 4]]",78288,up,8,"[[1024, 2, 256, 8], [2, 32, 16, 2], [4, 64, 0, 0], [0, 0, 0, 0]]",78296
5,"[[1024, 2, 256, 8], [2, 32, 16, 2], [4, 64, 0, 0], [0, 0, 0, 0]]",78296,right,0,"[[1024, 2, 256, 8], [2, 32, 16, 2], [0, 0, 4, 64], [0, 2, 0, 0]]",78296
5,"[[1024, 2, 256, 8], [2, 32, 16, 2], [0, 0, 4, 64], [0, 2, 0, 0]]",78296,right,0,"[[1024, 2, 256, 8], [2, 32, 16, 2], [0, 0, 4, 64], [2, 0, 0, 2]]",78296
5,"[[1024, 2, 256, 8], [2, 32, 16, 2], [0, 0, 4, 64], [2, 0, 0, 2]]",78296,left,4,"[[1024, 2, 256, 8], [2, 32, 16, 2], [4, 64, 0, 0], [4, 2, 0, 0]]",78300
5,"[[1024, 2, 256, 8], [2, 32, 16, 2], [4, 64, 0, 0], [4, 2, 0, 0]]",78300,up,8,"[[1024, 2, 256, 8], [2, 32, 16, 2], [8, 64, 0, 0], [0, 2, 2, 0]]",78308
5,"[[1024, 2, 256, 8], [2, 32, 16, 2], [8, 64, 0, 0], [0, 2, 2, 0]]",78308,right,4,"[[1024, 2, 256, 8], [2, 32, 16, 2], [0, 0, 8, 64], [0, 2, 0, 4]]",78312
5,"[[1024, 2, 256, 8], [2, 32, 16, 2], [0, 0, 8, 64], [0, 2, 0, 4]]",78312,down,0,"[[0, 2, 0, 8], [0, 2, 256, 2], [1024, 32, 16, 64], [2, 2, 8, 4]]",78312
5,"[[0, 2, 0, 8], [0, 2, 256, 2], [1024, 32, 16, 64], [2, 2, 8, 4]]",78312,left,4,"[[2, 8, 0, 0], [2, 256, 2, 2], [1024, 32, 16, 64], [4, 8, 4, 0]]",78316
5,"[[2, 8, 0, 0], [2, 256, 2, 2], [1024, 32, 16, 64], [4, 8, 4, 0]]",78316,left,4,"[[2, 8, 0, 2], [2, 256, 4, 0], [1024, 32, 16, 64], [4, 8, 4, 0]]",78320
5,"[[2, 8, 0, 2], [2, 256, 4, 0], [1024, 32, 16, 64], [4, 8, 4, 0]]",78320,down,4,"[[0, 8, 0, 2], [4, 256, 4, 0], [1024, 32, 16, 2], [4, 8, 4, 64]]",78324
5,"[[0, 8, 0, 2], [4, 256, 4, 0], [1024, 32, 16, 2], [4, 8, 4, 64]]",78324,up,4,"[[4, 8, 4, 4], [1024, 256, 16, 64], [4, 32, 4, 0], [4, 8, 0, 0]]",78328
5,"[[4, 8, 4, 4], [1024, 256, 16, 64], [4, 32, 4, 0], [4, 8, 0, 0]]",78328,left,8,"[[4, 8, 8, 0], [1024, 256, 16, 64], [4, 32, 4, 0], [4, 8, 2, 0]]",78336
5,"[[4, 8, 8, 0], [1024, 256, 16, 64], [4, 32, 4, 0], [4, 8, 2, 0]]",78336,down,8,"[[0, 8, 8, 0], [4, 256, 16, 0], [1024, 32, 4, 2], [8, 8, 2, 64]]",78344
5,"[[0, 8, 8, 0], [4, 256, 16, 0], [1024, 32, 4, 2], [8, 8, 2, 64]]",78344,right,32,"[[0, 0, 0, 16], [0, 4, 256, 16], [1024, 32, 4, 2], [4, 16, 2, 64]]",78376
5,"[[0, 0, 0, 16], [0, 4, 256, 16], [1024, 32, 4, 2], [4, 16, 2, 64]]",78376,down,32,"[[4, 0, 0, 0], [0, 4, 256, 32], [1024, 32, 4, 2], [4, 16, 2, 64]]",78408
5,"[[4, 0, 0, 0], [0, 4, 256, 32], [1024, 32, 4, 2], [4, 16, 2, 64]]",78408,left,0,"[[4, 0, 0, 0], [4, 256, 32, 2], [1024, 32, 4, 2], [4, 16, 2, 64]]",78408
5,"[[4, 0, 0, 0], [4, 256, 32, 2], [1024, 32, 4, 2], [4, 16, 2, 64]]",78408,down,12,"[[4, 0, 0, 0], [8, 256, 32, 0], [1024, 32, 4, 4], [4, 16, 2, 64]]",78420
5,"[[4, 0, 0, 0], [8, 256, 32, 0], [1024, 32, 4, 4], [4, 16, 2, 64]]",78420,down,0,"[[4, 0, 4, 0], [8, 256, 32, 0], [1024, 32, 4, 4], [4, 16, 2, 64]]",78420
5,"[[4, 0, 4, 0], [8, 256, 32, 0], [1024, 32, 4, 4], [4, 16, 2, 64]]",78420,up,0,"[[4, 256, 4, 4], [8, 32, 32, 64], [1024, 16, 4, 2], [4, 0, 2, 0]]",78420
5,"[[4, 256, 4, 4], [8, 32, 32, 64], [1024, 16, 4, 2], [4, 0, 2, 0]]",78420,right,72,"[[0, 4, 256, 8], [4, 8, 64, 64], [1024, 16, 4, 2], [0, 0, 4, 2]]",78492
5,"[[0, 4, 256, 8], [4, 8, 64, 64], [1024, 16, 4, 2], [0, 0, 4, 2]]",78492,right,128,"[[0, 4, 256, 8], [0, 4, 8, 128], [1024, 16, 4, 2], [0, 2, 4, 2]]",78620
5,"[[0, 4, 256, 8], [0, 4, 8, 128], [1024, 16, 4, 2], [0, 2, 4, 2]]",78620,up,20,"[[1024, 8, 256, 8], [0, 16, 8, 128], [0, 2, 8, 4], [0, 2, 0, 0]]",78640
5,"[[1024, 8, 256, 8], [0, 16, 8, 128], [0, 2, 8, 4], [0, 2, 0, 0]]",78640,up,20,"[[1024, 8, 256, 8], [0, 16, 16, 128], [4, 4, 0, 4], [0, 0, 0, 0]]",78660
5,"[[1024, 8, 256, 8], [0, 16, 16, 128], [4, 4, 0, 4], [0, 0, 0, 0]]",78660,right,40,"[[1024, 8, 256, 8], [0, 0, 32, 128], [0, 2, 4, 8], [0, 0, 0, 0]]",78700
5,"[[1024, 8, 256, 8], [0, 0, 32, 128], [0, 2, 4, 8], [0, 0, 0, 0]]",78700,right,0,"[[1024, 8, 256, 8], [0, 0, 32, 128], [0, 2, 4, 8], [4, 0, 0, 0]]",78700
5,"[[1024, 8, 256, 8], [0, 0, 32, 128], [0, 2, 4, 8], [4, 0, 0, 0]]",78700,up,0,"[[1024, 8, 256, 8], [4, 2, 32, 128], [0, 2, 4, 8], [0, 0, 0, 0]]",78700
5,"[[1024, 8, 256, 8], [4, 2, 32, 128], [0, 2, 4, 8], [0, 0, 0, 0]]",78700,up,4,"[[1024, 8, 256, 8], [4, 4, 32, 128], [0, 0, 4, 8], [4, 0, 0, 0]]",78704
5,"[[1024, 8, 256, 8], [4, 4, 32, 128], [0, 0, 4, 8], [4, 0, 0, 0]]",78704,down,8,"[[0, 0, 0, 2], [0, 0, 256, 8], [1024, 8, 32, 128], [8, 4, 4, 8]]",78712
5,"[[0, 0, 0, 2], [0, 0, 256, 8], [1024, 8, 32, 128], [8, 4, 4, 8]]",78712,left,8,"[[2, 4, 0, 0], [256, 8, 0, 0], [1024, 8, 32, 128], [8, 8, 8, 0]]",78720
5,"[[2, 4, 0, 0], [256, 8, 0, 0], [1024, 8, 32, 128], [8, 8, 8, 0]]",78720,down,16,"[[2, 0, 4, 0], [256, 4, 0, 0], [1024, 8, 32, 0], [8, 16, 8, 128]]",78736
5,"[[2, 0, 4, 0], [256, 4, 0, 0], [1024, 8, 32, 0], [8, 16, 8, 128]]",78736,right,0,"[[0, 2, 2, 4], [0, 0, 256, 4], [0, 1024, 8, 32], [8, 16, 8, 128]]",78736
5,"[[0, 2, 2, 4], [0, 0, 256, 4], [0, 1024, 8, 32], [8, 16, 8, 128]]",78736,down,24,"[[0, 2, 0, 0], [0, 2, 2, 8], [0, 1024, 256, 32], [8, 16, 16, 128]]",78760
5,"[[0, 2, 0, 0], [0, 2, 2, 8], [0, 1024, 256, 32], [8, 16, 16, 128]]",78760,right,36,"[[0, 2, 0, 2], [0, 0, 4, 8], [0, 1024, 256, 32], [0, 8, 32, 128]]",78796
5,"[[0, 2, 0, 2], [0, 0, 4, 8], [0, 1024, 256, 32], [0, 8, 32, 128]]",78796,up,0,"[[0, 2, 4, 2], [0, 1024, 256, 8], [0, 8, 32, 32], [4, 0, 0, 128]]",78796
5,"[[0, 2, 4, 2], [0, 1024, 256, 8], [0, 8, 32, 32], [4, 0, 0, 128]]",78796,right,64,"[[4, 2, 4, 2], [0, 1024, 256, 8], [0, 0, 8, 64], [0, 0, 4, 128]]",78860
5,"[[4, 2, 4, 2], [0, 1024, 256, 8], [0, 0, 8, 64], [0, 0, 4, 128]]",78860,down,0,"[[0, 0, 4, 2], [4, 0, 256, 8], [0, 2, 8, 64], [4, 1024, 4, 128]]",78860
5,"[[0, 0, 4, 2], [4, 0, 256, 8], [0, 2, 8, 64], [4, 1024, 4, 128]]",78860,down,8,"[[0, 4, 4, 2], [0, 0, 256, 8], [0, 2, 8, 64], [8, 1024, 4, 128]]",78868
5,"[[0, 4, 4, 2], [0, 0, 256, 8], [0, 2, 8, 64], [8, 1024, 4, 128]]",78868,left,8,"[[8, 2, 0, 0], [256, 8, 0, 0], [2, 8, 64, 4], [8, 1024, 4, 128]]",78876
5,"[[8, 2, 0, 0], [256, 8, 0, 0], [2, 8, 64, 4], [8, 1024, 4, 128]]",78876,down,16,"[[8, 2, 0, 0], [256, 2, 0, 0], [2, 16, 64, 4], [8, 1024, 4, 128]]",78892
5,"[[8, 2, 0, 0], [256, 2, 0, 0], [2, 16, 64, 4], [8, 1024, 4, 128]]",78892,down,4,"[[8, 0, 0, 0], [256, 4, 0, 2], [2, 16, 64, 4], [8, 1024, 4, 128]]",78896
5,"[[8, 0, 0, 0], [256, 4, 0, 2], [2, 16, 64, 4], [8, 1024, 4, 128]]",78896,down,0,"[[8, 0, 0, 4], [256, 4, 0, 2], [2, 16, 64, 4], [8, 1024, 4, 128]]",78896
5,"[[8, 0, 0, 4], [256, 4, 0, 2], [2, 16, 64, 4], [8, 1024, 4, 128]]",78896,left,0,"[[8, 4, 0, 0], [256, 4, 2, 4], [2, 16, 64, 4], [8, 1024, 4, 128]]",78896
5,"[[8, 4, 0, 0], [256, 4, 2, 4], [2, 16, 64, 4], [8, 1024, 4, 128]]",78896,up,16,"[[8, 8, 2, 8], [256, 16, 64, 128], [2, 1024, 4, 0], [8, 0, 0, 4]]",78912
5,"[[8, 8, 2, 8], [256, 16, 64, 128], [2, 1024, 4, 0], [8, 0, 0, 4]]",78912,right,16,"[[0, 16, 2, 8], [256, 16, 64, 128], [4, 2, 1024, 4], [0, 0, 8, 4]]",78928
5,"[[0, 16, 2, 8], [256, 16, 64, 128], [4, 2, 1024, 4], [0, 0, 8, 4]]",78928,down,40,"[[0, 4, 2, 0], [0, 0, 64, 8], [256, 32, 1024, 128], [4, 2, 8, 8]]",78968
5,"[[0, 4, 2, 0], [0, 0, 64, 8], [256, 32, 1024, 128], [4, 2, 8, 8]]",78968,left,16,"[[4, 2, 0, 0], [64, 8, 4, 0], [256, 32, 1024, 128], [4, 2, 16, 0]]",78984
5,"[[4, 2, 0, 0], [64, 8, 4, 0], [256, 32, 1024, 128], [4, 2, 16, 0]]",78984,down,0,"[[4, 2, 0, 0], [64, 8, 4, 4], [256, 32, 1024, 0], [4, 2, 16, 128]]",78984
5,"[[4, 2, 0, 0], [64, 8, 4, 4], [256, 32, 1024, 0], [4, 2, 16, 128]]",78984,right,8,"[[0, 0, 4, 2], [2, 64, 8, 8], [0, 256, 32, 1024], [4, 2, 16, 128]]",78992
5,"[[0, 0, 4, 2], [2, 64, 8, 8], [0, 256, 32, 1024], [4, 2, 16, 128]]",78992,right,16,"[[0, 0, 4, 2], [0, 2, 64, 16], [2, 256, 32, 1024], [4, 2, 16, 128]]",79008
5,"[[0, 0, 4, 2], [0, 2, 64, 16], [2, 256, 32, 1024], [4, 2, 16, 128]]",79008,up,0,"[[2, 2, 4, 2], [4, 256, 64, 16], [2, 2, 32, 1024], [0, 0, 16, 128]]",79008
5,"[[2, 2, 4, 2], [4, 256, 64, 16], [2, 2, 32, 1024], [0, 0, 16, 128]]",79008,left,8,"[[4, 4, 2, 0], [4, 256, 64, 16], [4, 32, 1024, 4], [16, 128, 0, 0]]",79016
5,"[[4, 4, 2, 0], [4, 256, 64, 16], [4, 32, 1024, 4], [16, 128, 0, 0]]",79016,left,8,"[[8, 2, 0, 0], [4, 256, 64, 16], [4, 32, 1024, 4], [16, 128, 0, 2]]",79024
5,"[[8, 2, 0, 0], [4, 256, 64, 16], [4, 32, 1024, 4], [16, 128, 0, 2]]",79024,up,8,"[[8, 2, 64, 16], [8, 256, 1024, 4], [16, 32, 0, 2], [0, 128, 0, 2]]",79032
5,"[[8, 2, 64, 16], [8, 256, 1024, 4], [16, 32, 0, 2], [0, 128, 0, 2]]",79032,down,20,"[[0, 2, 0, 0], [2, 256, 0, 16], [16, 32, 64, 4], [16, 128, 1024, 4]]",79052
5,"[[0, 2, 0, 0], [2, 256, 0, 16], [16, 32, 64, 4], [16, 128, 1024, 4]]",79052,up,40,"[[2, 2, 64, 16], [32, 256, 1024, 8], [0, 32, 0, 0], [0, 128, 4, 0]]",79092
5,"[[2, 2, 64, 16], [32, 256, 1024, 8], [0, 32, 0, 0], [0, 128, 4, 0]]",79092,left,4,"[[4, 64, 16, 0], [32, 256, 1024, 8], [32, 0, 0, 0], [128, 4, 0, 4]]",79096
5,"[[4, 64, 16, 0], [32, 256, 1024, 8], [32, 0, 0, 0], [128, 4, 0, 4]]",79096,up,64,"[[4, 64, 16, 8], [64, 256, 1024, 4], [128, 4, 0, 0], [0, 0, 0, 2]]",79160
5,"[[4, 64, 16, 8], [64, 256, 1024, 4], [128, 4, 0, 0], [0, 0, 0, 2]]",79160,left,0,"[[4, 64, 16, 8], [64, 256, 1024, 4], [128, 4, 0, 0], [2, 4, 0, 0]]",79160
5,"[[4, 64, 16, 8], [64, 256, 1024, 4], [128, 4, 0, 0], [2, 4, 0, 0]]",79160,down,8,"[[4, 0, 2, 0], [64, 64, 0, 0], [128, 256, 16, 8], [2, 8, 1024, 4]]",79168
5,"[[4, 0, 2, 0], [64, 64, 0, 0], [128, 256, 16, 8], [2, 8, 1024, 4]]",79168,left,128,"[[4, 2, 2, 0], [128, 0, 0, 0], [128, 256, 16, 8], [2, 8, 1024, 4]]",79296
5,"[[4, 2, 2, 0], [128, 0, 0, 0], [128, 256, 16, 8], [2, 8, 1024, 4]]",79296,up,256,"[[4, 2, 2, 8], [256, 256, 16, 4], [2, 8, 1024, 0], [0, 0, 2, 0]]",79552
5,"[[4, 2, 2, 8], [256, 256, 16, 4], [2, 8, 1024, 0], [0, 0, 2, 0]]",79552,left,516,"[[4, 4, 8, 0], [512, 16, 4, 0], [2, 8, 1024, 0], [2, 4, 0, 0]]",80068
5,"[[4, 4, 8, 0], [512, 16, 4, 0], [2, 8, 1024, 0], [2, 4, 0, 0]]",80068,left,8,"[[8, 8, 0, 0], [512, 16, 4, 2], [2, 8, 1024, 0], [2, 4, 0, 0]]",80076
5,"[[8, 8, 0, 0], [512, 16, 4, 2], [2, 8, 1024, 0], [2, 4, 0, 0]]",80076,left,16,"[[16, 4, 0, 0], [512, 16, 4, 2], [2, 8, 1024, 0], [2, 4, 0, 0]]",80092
5,"[[16, 4, 0, 0], [512, 16, 4, 2], [2, 8, 1024, 0], [2, 4, 0, 0]]",80092,down,4,"[[0, 4, 2, 0], [16, 16, 0, 0], [512, 8, 4, 0], [4, 4, 1024, 2]]",80096
5,"[[0, 4, 2, 0], [16, 16, 0, 0], [512, 8, 4, 0], [4, 4, 1024, 2]]",80096,left,40,"[[4, 2, 0, 2], [32, 0, 0, 0], [512, 8, 4, 0], [8, 1024, 2, 0]]",80136
5,"[[4, 2, 0, 2], [32, 0, 0, 0], [512, 8, 4, 0], [8, 1024, 2, 0]]",80136,left,4,"[[4, 4, 0, 0], [32, 0, 0, 0], [512, 8, 4, 4], [8, 1024, 2, 0]]",80140
5,"[[4, 4, 0, 0], [32, 0, 0, 0], [512, 8, 4, 4], [8, 1024, 2, 0]]",80140,right,16,"[[0, 0, 0, 8], [0, 0, 0, 32], [2, 512, 8, 8], [0, 8, 1024, 2]]",80156
5,"[[0, 0, 0, 8], [0, 0, 0, 32], [2, 512, 8, 8], [0, 8, 1024, 2]]",80156,right,16,"[[0, 0, 0, 8], [0, 4, 0, 32], [0, 2, 512, 16], [0, 8, 1024, 2]]",80172
5,"[[0, 0, 0, 8], [0, 4, 0, 32], [0, 2, 512, 16], [0, 8, 1024, 2]]",80172,right,0,"[[2, 0, 0, 8], [0, 0, 4, 32], [0, 2, 512, 16], [0, 8, 1024, 2]]",80172
5,"[[2, 0, 0, 8], [0, 0, 4, 32], [0, 2, 512, 16], [0, 8, 1024, 2]]",80172,up,0,"[[2, 2, 4, 8], [0, 8, 512, 32], [0, 2, 1024, 16], [0, 0, 0, 2]]",80172
5,"[[2, 2, 4, 8], [0, 8, 512, 32], [0, 2, 1024, 16], [0, 0, 0, 2]]",80172,left,4,"[[4, 4, 8, 0], [8, 512, 32, 0], [2, 1024, 16, 0], [2, 2, 0, 0]]",80176
5,"[[4, 4, 8, 0], [8, 512, 32, 0], [2, 1024, 16, 0], [2, 2, 0, 0]]",80176,left,12,"[[8, 8, 0, 2], [8, 512, 32, 0], [2, 1024, 16, 0], [4, 0, 0, 0]]",80188
5,"[[8, 8, 0, 2], [8, 512, 32, 0], [2, 1024, 16, 0], [4, 0, 0, 0]]",80188,down,16,"[[0, 2, 0, 0], [16, 8, 0, 0], [2, 512, 32, 0], [4, 1024, 16, 2]]",80204
5,"[[0, 2, 0, 0], [16, 8, 0, 0], [2, 512, 32, 0], [4, 1024, 16, 2]]",80204,left,0,"[[2, 0, 0, 0], [16, 8, 2, 0], [2, 512, 32, 0], [4, 1024, 16, 2]]",80204
5,"[[2, 0, 0, 0], [16, 8, 2, 0], [2, 512, 32, 0], [4, 1024, 16, 2]]",80204,right,0,"[[0, 2, 0, 2], [0, 16, 8, 2], [0, 2, 512, 32], [4, 1024, 16, 2]]",80204
5,"[[0, 2, 0, 2], [0, 16, 8, 2], [0, 2, 512, 32], [4, 1024, 16, 2]]",80204,down,4,"[[0, 2, 0, 0], [0, 16, 8, 4], [2, 2, 512, 32], [4, 1024, 16, 2]]",80208
5,"[[0, 2, 0, 0], [0, 16, 8, 4], [2, 2, 512, 32], [4, 1024, 16, 2]]",80208,left,4,"[[2, 0, 0, 0], [16, 8, 4, 4], [4, 512, 32, 0], [4, 1024, 16, 2]]",80212
5,"[[2, 0, 0, 0], [16, 8, 4, 4], [4, 512, 32, 0], [4, 1024, 16, 2]]",80212,right,8,"[[0, 0, 0, 2], [4, 16, 8, 8], [0, 4, 512, 32], [4, 1024, 16, 2]]",80220
5,"[[0, 0, 0, 2], [4, 16, 8, 8], [0, 4, 512, 32], [4, 1024, 16, 2]]",80220,right,16,"[[0, 0, 2, 2], [0, 4, 16, 16], [0, 4, 512, 32], [4, 1024, 16, 2]]",80236
5,"[[0, 0, 2, 2], [0, 4, 16, 16], [0, 4, 512, 32], [4, 1024, 16, 2]]",80236,right,36,"[[0, 0, 0, 4], [2, 0, 4, 32], [0, 4, 512, 32], [4, 1024, 16, 2]]",80272
5,"[[0, 0, 0, 4], [2, 0, 4, 32], [0, 4, 512, 32], [4, 1024, 16, 2]]",80272,down,64,"[[0, 4, 0, 0], [0, 0, 4, 4], [2, 4, 512, 64], [4, 1024, 16, 2]]",80336
5,"[[0, 4, 0, 0], [0, 0, 4, 4], [2, 4, 512, 64], [4, 1024, 16, 2]]",80336,up,8,"[[2, 8, 4, 4], [4, 1024, 512, 64], [0, 0, 16, 2], [0, 0, 0, 2]]",80344
5,"[[2, 8, 4, 4], [4, 1024, 512, 64], [0, 0, 16, 2], [0, 0, 0, 2]]",80344,right,8,"[[0, 2, 8, 8], [4, 1024, 512, 64], [0, 0, 16, 2], [0, 0, 4, 2]]",80352
5,"[[0, 2, 8, 8], [4, 1024, 512, 64], [0, 0, 16, 2], [0, 0, 4, 2]]",80352,right,16,"[[0, 0, 2, 16], [4, 1024, 512, 64], [0, 2, 16, 2], [0, 0, 4, 2]]",80368
5,"[[0, 0, 2, 16], [4, 1024, 512, 64], [0, 2, 16, 2], [0, 0, 4, 2]]",80368,down,4,"[[0, 0, 2, 0], [4, 0, 512, 16], [0, 1024, 16, 64], [4, 2, 4, 4]]",80372
5,"[[0, 0, 2, 0], [4, 0, 512, 16], [0, 1024, 16, 64], [4, 2, 4, 4]]",80372,down,8,"[[0, 0, 2, 0], [0, 0, 512, 16], [2, 1024, 16, 64], [8, 2, 4, 4]]",80380
5,"[[0, 0, 2, 0], [0, 0, 512, 16], [2, 1024, 16, 64], [8, 2, 4, 4]]",80380,right,8,"[[2, 0, 0, 2], [0, 0, 512, 16], [2, 1024, 16, 64], [0, 8, 2, 8]]",80388
5,"[[2, 0, 0, 2], [0, 0, 512, 16], [2, 1024, 16, 64], [0, 8, 2, 8]]",80388,up,4,"[[4, 1024, 512, 2], [0, 8, 16, 16], [4, 0, 2, 64], [0, 0, 0, 8]]",80392
5,"[[4, 1024, 512, 2], [0, 8, 16, 16], [4, 0, 2, 64], [0, 0, 0, 8]]",80392,right,32,"[[4, 1024, 512, 2], [0, 0, 8, 32], [4, 4, 2, 64], [0, 0, 0, 8]]",80424
5,"[[4, 1024, 512, 2], [0, 0, 8, 32], [4, 4, 2, 64], [0, 0, 0, 8]]",80424,left,8,"[[4, 1024, 512, 2], [8, 32, 0, 0], [8, 2, 64, 0], [8, 0, 2, 0]]",80432
5,"[[4, 1024, 512, 2], [8, 32, 0, 0], [8, 2, 64, 0], [8, 0, 2, 0]]",80432,up,16,"[[4, 1024, 512, 2], [16, 32, 64, 0], [8, 2, 2, 0], [0, 0, 2, 0]]",80448
5,"[[4, 1024, 512, 2], [16, 32, 64, 0], [8, 2, 2, 0], [0, 0, 2, 0]]",80448,left,4,"[[4, 1024, 512, 2], [16, 32, 64, 0], [8, 4, 2, 0], [2, 0, 0, 0]]",80452
5,"[[4, 1024, 512, 2], [16, 32, 64, 0], [8, 4, 2, 0], [2, 0, 0, 0]]",80452,right,0,"[[4, 1024, 512, 2], [0, 16, 32, 64], [0, 8, 4, 2], [0, 0, 4, 2]]",80452
5,"[[4, 1024, 512, 2], [0, 16, 32, 64], [0, 8, 4, 2], [0, 0, 4, 2]]",80452,up,12,"[[4, 1024, 512, 2], [0, 16, 32, 64], [2, 8, 8, 4], [0, 0, 0, 0]]",80464
5,"[[4, 1024, 512, 2], [0, 16, 32, 64], [2, 8, 8, 4], [0, 0, 0, 0]]",80464,down,0,"[[0, 0, 2, 0], [0, 1024, 512, 2], [4, 16, 32, 64], [2, 8, 8, 4]]",80464
5,"[[0, 0, 2, 0], [0, 1024, 512, 2], [4, 16, 32, 64], [2, 8, 8, 4]]",80464,left,16,"[[2, 0, 0, 0], [1024, 512, 2, 4], [4, 16, 32, 64], [2, 16, 4, 0]]",80480
5,"[[2, 0, 0, 0], [1024, 512, 2, 4], [4, 16, 32, 64], [2, 16, 4, 0]]",80480,up,32,"[[2, 512, 2, 4], [1024, 32, 32, 64], [4, 4, 4, 0], [2, 0, 0, 0]]",80512
5,"[[2, 512, 2, 4], [1024, 32, 32, 64], [4, 4, 4, 0], [2, 0, 0, 0]]",80512,left,72,"[[2, 512, 2, 4], [1024, 64, 64, 0], [8, 4, 2, 0], [2, 0, 0, 0]]",80584
5,"[[2, 512, 2, 4], [1024, 64, 64, 0], [8, 4, 2, 0], [2, 0, 0, 0]]",80584,left,128,"[[2, 512, 2, 4], [1024, 128, 4, 0], [8, 4, 2, 0], [2, 0, 0, 0]]",80712
5,"[[2, 512, 2, 4], [1024, 128, 4, 0], [8, 4, 2, 0], [2, 0, 0, 0]]",80712,right,0,"[[2, 512, 2, 4], [0, 1024, 128, 4], [4, 8, 4, 2], [0, 0, 0, 2]]",80712
5,"[[2, 512, 2, 4], [0, 1024, 128, 4], [4, 8, 4, 2], [0, 0, 0, 2]]",80712,down,12,"[[0, 0, 4, 0], [0, 512, 2, 0], [2, 1024, 128, 8], [4, 8, 4, 4]]",80724
5,"[[0, 0, 4, 0], [0, 512, 2, 0], [2, 1024, 128, 8], [4, 8, 4, 4]]",80724,right,8,"[[0, 0, 2, 4], [0, 0, 512, 2], [2, 1024, 128, 8], [0, 4, 8, 8]]",80732
5,"[[0, 0, 2, 4], [0, 0, 512, 2], [2, 1024, 128, 8], [0, 4, 8, 8]]",80732,left,16,"[[2, 4, 0, 0], [512, 2, 0, 0], [2, 1024, 128, 8], [4, 16, 0, 2]]",80748
5,"[[2, 4, 0, 0], [512, 2, 0, 0], [2, 1024, 128, 8], [4, 16, 0, 2]]",80748,down,0,"[[2, 4, 0, 2], [512, 2, 0, 0], [2, 1024, 0, 8], [4, 16, 128, 2]]",80748
5,"[[2, 4, 0, 2], [512, 2, 0, 0], [2, 1024, 0, 8], [4, 16, 128, 2]]",80748,right,0,"[[0, 2, 4, 2], [0, 2, 512, 2], [0, 2, 1024, 8], [4, 16, 128, 2]]",80748
5,"[[0, 2, 4, 2], [0, 2, 512, 2], [0, 2, 1024, 8], [4, 16, 128, 2]]",80748,up,8,"[[4, 4, 4, 4], [0, 2, 512, 8], [4, 16, 1024, 2], [0, 0, 128, 0]]",80756
5,"[[4, 4, 4, 4], [0, 2, 512, 8], [4, 16, 1024, 2], [0, 0, 128, 0]]",80756,right,16,"[[0, 0, 8, 8], [0, 2, 512, 8], [4, 16, 1024, 2], [4, 0, 0, 128]]",80772
5,"[[0, 0, 8, 8], [0, 2, 512, 8], [4, 16, 1024, 2], [4, 0, 0, 128]]",80772,down,24,"[[0, 0, 0, 4], [0, 0, 8, 16], [0, 2, 512, 2], [8, 16, 1024, 128]]",80796
5,"[[0, 0, 0, 4], [0, 0, 8, 16], [0, 2, 512, 2], [8, 16, 1024, 128]]",80796,down,0,"[[2, 0, 0, 4], [0, 0, 8, 16], [0, 2, 512, 2], [8, 16, 1024, 128]]",80796
5,"[[2, 0, 0, 4], [0, 0, 8, 16], [0, 2, 512, 2], [8, 16, 1024, 128]]",80796,up,0,"[[2, 2, 8, 4], [8, 16, 512, 16], [4, 0, 1024, 2], [0, 0, 0, 128]]",80796
5,"[[2, 2, 8, 4], [8, 16, 512, 16], [4, 0, 1024, 2], [0, 0, 0, 128]]",80796,right,4,"[[0, 4, 8, 4], [8, 16, 512, 16], [0, 4, 1024, 2], [0, 0, 2, 128]]",80800
5,"[[0, 4, 8, 4], [8, 16, 512, 16], [0, 4, 1024, 2], [0, 0, 2, 128]]",80800,right,0,"[[0, 4, 8, 4], [8, 16, 512, 16], [0, 4, 1024, 2], [2, 0, 2, 128]]",80800
5,"[[0, 4, 8, 4], [8, 16, 512, 16], [0, 4, 1024, 2], [2, 0, 2, 128]]",80800,left,4,"[[4, 8, 4, 0], [8, 16, 512, 16], [4, 1024, 2, 0], [4, 128, 2, 0]]",80804
5,"[[4, 8, 4, 0], [8, 16, 512, 16], [4, 1024, 2, 0], [4, 128, 2, 0]]",80804,down,12,"[[0, 8, 0, 2], [4, 16, 4, 0], [8, 1024, 512, 0], [8, 128, 4, 16]]",80816
5,"[[0, 8, 0, 2], [4, 16, 4, 0], [8, 1024, 512, 0], [8, 128, 4, 16]]",80816,up,16,"[[4, 8, 4, 2], [16, 16, 512, 16], [0, 1024, 4, 0], [0, 128, 2, 0]]",80832
5,"[[4, 8, 4, 2], [16, 16, 512, 16], [0, 1024, 4, 0], [0, 128, 2, 0]]",80832,left,32,"[[4, 8, 4, 2], [32, 512, 16, 0], [1024, 4, 4, 0], [128, 2, 0, 0]]",80864
5,"[[4, 8, 4, 2], [32, 512, 16, 0], [1024, 4, 4, 0], [128, 2, 0, 0]]",80864,left,8,"[[4, 8, 4, 2], [32, 512, 16, 4], [1024, 8, 0, 0], [128, 2, 0, 0]]",80872
5,"[[4, 8, 4, 2], [32, 512, 16, 4], [1024, 8, 0, 0], [128, 2, 0, 0]]",80872,down,0,"[[4, 8, 0, 0], [32, 512, 0, 2], [1024, 8, 4, 2], [128, 2, 16, 4]]",80872
5,"[[4, 8, 0, 0], [32, 512, 0, 2], [1024, 8, 4, 2], [128, 2, 16, 4]]",80872,up,4,"[[4, 8, 4, 4], [32, 512, 16, 4], [1024, 8, 0, 0], [128, 2, 4, 0]]",80876
5,"[[4, 8, 4, 4], [32, 512, 16, 4], [1024, 8, 0, 0], [128, 2, 4, 0]]",80876,left,8,"[[4, 8, 8, 0], [32, 512, 16, 4], [1024, 8, 0, 0], [128, 2, 4, 4]]",80884
5,"[[4, 8, 8, 0], [32, 512, 16, 4], [1024, 8, 0, 0], [128, 2, 4, 4]]",80884,right,24,"[[2, 0, 4, 16], [32, 512, 16, 4], [0, 0, 1024, 8], [0, 128, 2, 8]]",80908
5,"[[2, 0, 4, 16], [32, 512, 16, 4], [0, 0, 1024, 8], [0, 128, 2, 8]]",80908,down,16,"[[0, 0, 4, 0], [2, 0, 16, 16], [2, 512, 1024, 4], [32, 128, 2, 16]]",80924
5,"[[0, 0, 4, 0], [2, 0, 16, 16], [2, 512, 1024, 4], [32, 128, 2, 16]]",80924,left,32,"[[4, 0, 0, 2], [2, 32, 0, 0], [2, 512, 1024, 4], [32, 128, 2, 16]]",80956
5,"[[4, 0, 0, 2], [2, 32, 0, 0], [2, 512, 1024, 4], [32, 128, 2, 16]]",80956,down,4,"[[0, 0, 0, 4], [4, 32, 0, 2], [4, 512, 1024, 4], [32, 128, 2, 16]]",80960
5,"[[0, 0, 0, 4], [4, 32, 0, 2], [4, 512, 1024, 4], [32, 128, 2, 16]]",80960,up,8,"[[8, 32, 1024, 4], [32, 512, 2, 2], [0, 128, 4, 4], [0, 0, 0, 16]]",80968
5,"[[8, 32, 1024, 4], [32, 512, 2, 2], [0, 128, 4, 4], [0, 0, 0, 16]]",80968,right,12,"[[8, 32, 1024, 4], [0, 32, 512, 4], [0, 0, 128, 8], [0, 0, 4, 16]]",80980
5,"[[8, 32, 1024, 4], [0, 32, 512, 4], [0, 0, 128, 8], [0, 0, 4, 16]]",80980,down,72,"[[0, 0, 1024, 0], [0, 4, 512, 8], [0, 0, 128, 8], [8, 64, 4, 16]]",81052
5,"[[0, 0, 1024, 0], [0, 4, 512, 8], [0, 0, 128, 8], [8, 64, 4, 16]]",81052,down,16,"[[2, 0, 1024, 0], [0, 0, 512, 0], [0, 4, 128, 16], [8, 64, 4, 16]]",81068
5,"[[2, 0, 1024, 0], [0, 0, 512, 0], [0, 4, 128, 16], [8, 64, 4, 16]]",81068,down,32,"[[0, 0, 1024, 0], [0, 0, 512, 0], [2, 4, 128, 2], [8, 64, 4, 32]]",81100
5,"[[0, 0, 1024, 0], [0, 0, 512, 0], [2, 4, 128, 2], [8, 64, 4, 32]]",81100,right,0,"[[2, 0, 0, 1024], [0, 0, 0, 512], [2, 4, 128, 2], [8, 64, 4, 32]]",81100
5,"[[2, 0, 0, 1024], [0, 0, 0, 512], [2, 4, 128, 2], [8, 64, 4, 32]]",81100,up,4,"[[4, 4, 128, 1024], [8, 64, 4, 512], [2, 0, 0, 2], [0, 0, 0, 32]]",81104
5,"[[4, 4, 128, 1024], [8, 64, 4, 512], [2, 0, 0, 2], [0, 0, 0, 32]]",81104,left,12,"[[8, 128, 1024, 0], [8, 64, 4, 512], [4, 4, 0, 0], [32, 0, 0, 0]]",81116
5,"[[8, 128, 1024, 0], [8, 64, 4, 512], [4, 4, 0, 0], [32, 0, 0, 0]]",81116,down,16,"[[0, 0, 0, 0], [16, 128, 0, 4], [4, 64, 1024, 0], [32, 4, 4, 512]]",81132
5,"[[0, 0, 0, 0], [16, 128, 0, 4], [4, 64, 1024, 0], [32, 4, 4, 512]]",81132,left,8,"[[0, 0, 0, 4], [16, 128, 4, 0], [4, 64, 1024, 0], [32, 8, 512, 0]]",81140
5,"[[0, 0, 0, 4], [16, 128, 4, 0], [4, 64, 1024, 0], [32, 8, 512, 0]]",81140,right,0,"[[0, 0, 4, 4], [0, 16, 128, 4], [0, 4, 64, 1024], [0, 32, 8, 512]]",81140
5,"[[0, 0, 4, 4], [0, 16, 128, 4], [0, 4, 64, 1024], [0, 32, 8, 512]]",81140,down,8,"[[0, 2, 4, 0], [0, 16, 128, 8], [0, 4, 64, 1024], [0, 32, 8, 512]]",81148
5,"[[0, 2, 4, 0], [0, 16, 128, 8], [0, 4, 64, 1024], [0, 32, 8, 512]]",81148,right,0,"[[4, 0, 2, 4], [0, 16, 128, 8], [0, 4, 64, 1024], [0, 32, 8, 512]]",81148
5,"[[4, 0, 2, 4], [0, 16, 128, 8], [0, 4, 64, 1024], [0, 32, 8, 512]]",81148,down,0,"[[0, 0, 2, 4], [0, 16, 128, 8], [2, 4, 64, 1024], [4, 32, 8, 512]]",81148
5,"[[0, 0, 2, 4], [0, 16, 128, 8], [2, 4, 64, 1024], [4, 32, 8, 512]]",81148,up,0,"[[2, 16, 2, 4], [4, 4, 128, 8], [4, 32, 64, 1024], [0, 0, 8, 512]]",81148
5,"[[2, 16, 2, 4], [4, 4, 128, 8], [4, 32, 64, 1024], [0, 0, 8, 512]]",81148,right,8,"[[2, 16, 2, 4], [0, 8, 128, 8], [4, 32, 64, 1024], [2, 0, 8, 512]]",81156
5,"[[2, 16, 2, 4], [0, 8, 128, 8], [4, 32, 64, 1024], [2, 0, 8, 512]]",81156,right,0,"[[2, 16, 2, 4], [0, 8, 128, 8], [4, 32, 64, 1024], [4, 2, 8, 512]]",81156
5,"[[2, 16, 2, 4], [0, 8, 128, 8], [4, 32, 64, 1024], [4, 2, 8, 512]]",81156,up,8,"[[2, 16, 2, 4], [8, 8, 128, 8], [4, 32, 64, 1024], [0, 2, 8, 512]]",81164
5,"[[2, 16, 2, 4], [8, 8, 128, 8], [4, 32, 64, 1024], [0, 2, 8, 512]]",81164,right,16,"[[2, 16, 2, 4], [0, 16, 128, 8], [4, 32, 64, 1024], [4, 2, 8, 512]]",81180
5,"[[2, 16, 2, 4], [0, 16, 128, 8], [4, 32, 64, 1024], [4, 2, 8, 512]]",81180,down,40,"[[4, 0, 2, 4], [0, 32, 128, 8], [2, 32, 64, 1024], [8, 2, 8, 512]]",81220
5,"[[4, 0, 2, 4], [0, 32, 128, 8], [2, 32, 64, 1024], [8, 2, 8, 512]]",81220,down,64,"[[2, 0, 2, 4], [4, 0, 128, 8], [2, 64, 64, 1024], [8, 2, 8, 512]]",81284
5,"[[2, 0, 2, 4], [4, 0, 128, 8], [2, 64, 64, 1024], [8, 2, 8, 512]]",81284,right,132,"[[2, 0, 4, 4], [0, 4, 128, 8], [0, 2, 128, 1024], [8, 2, 8, 512]]",81416
5,"[[2, 0, 4, 4], [0, 4, 128, 8], [0, 2, 128, 1024], [8, 2, 8, 512]]",81416,down,260,"[[0, 0, 2, 4], [0, 0, 4, 8], [2, 4, 256, 1024], [8, 4, 8, 512]]",81676
5,"[[0, 0, 2, 4], [0, 0, 4, 8], [2, 4, 256, 1024], [8, 4, 8, 512]]",81676,down,8,"[[0, 0, 2, 4], [0, 0, 4, 8], [2, 2, 256, 1024], [8, 8, 8, 512]]",81684
5,"[[0, 0, 2, 4], [0, 0, 4, 8], [2, 2, 256, 1024], [8, 8, 8, 512]]",81684,left,20,"[[2, 4, 2, 0], [4, 8, 0, 0], [4, 256, 1024, 0], [16, 8, 512, 0]]",81704
5,"[[2, 4, 2, 0], [4, 8, 0, 0], [4, 256, 1024, 0], [16, 8, 512, 0]]",81704,up,8,"[[2, 4, 2, 0], [8, 8, 1024, 0], [16, 256, 512, 2], [0, 8, 0, 0]]",81712
5,"[[2, 4, 2, 0], [8, 8, 1024, 0], [16, 256, 512, 2], [0, 8, 0, 0]]",81712,left,16,"[[2, 4, 2, 4], [16, 1024, 0, 0], [16, 256, 512, 2], [8, 0, 0, 0]]",81728
5,"[[2, 4, 2, 4], [16, 1024, 0, 0], [16, 256, 512, 2], [8, 0, 0, 0]]",81728,down,32,"[[0, 0, 4, 0], [2, 4, 0, 0], [32, 1024, 2, 4], [8, 256, 512, 2]]",81760
5,"[[0, 0, 4, 0], [2, 4, 0, 0], [32, 1024, 2, 4], [8, 256, 512, 2]]",81760,up,0,"[[2, 4, 4, 4], [32, 1024, 2, 2], [8, 256, 512, 0], [4, 0, 0, 0]]",81760
5,"[[2, 4, 4, 4], [32, 1024, 2, 2], [8, 256, 512, 0], [4, 0, 0, 0]]",81760,left,12,"[[2, 8, 4, 0], [32, 1024, 4, 2], [8, 256, 512, 0], [4, 0, 0, 0]]",81772
5,"[[2, 8, 4, 0], [32, 1024, 4, 2], [8, 256, 512, 0], [4, 0, 0, 0]]",81772,up,8,"[[2, 8, 8, 2], [32, 1024, 512, 0], [8, 256, 0, 4], [4, 0, 0, 0]]",81780
5,"[[2, 8, 8, 2], [32, 1024, 512, 0], [8, 256, 0, 4], [4, 0, 0, 0]]",81780,right,16,"[[0, 2, 16, 2], [0, 32, 1024, 512], [2, 8, 256, 4], [0, 0, 0, 4]]",81796
5,"[[0, 2, 16, 2], [0, 32, 1024, 512], [2, 8, 256, 4], [0, 0, 0, 4]]",81796,up,8,"[[2, 2, 16, 2], [0, 32, 1024, 512], [0, 8, 256, 8], [0, 0, 2, 0]]",81804
5,"[[2, 2, 16, 2], [0, 32, 1024, 512], [0, 8, 256, 8], [0, 0, 2, 0]]",81804,right,4,"[[0, 4, 16, 2], [0, 32, 1024, 512], [0, 8, 256, 8], [4, 0, 0, 2]]",81808
5,"[[0, 4, 16, 2], [0, 32, 1024, 512], [0, 8, 256, 8], [4, 0, 0, 2]]",81808,up,0,"[[4, 4, 16, 2], [0, 32, 1024, 512], [0, 8, 256, 8], [0, 4, 0, 2]]",81808
5,"[[4, 4, 16, 2], [0, 32, 1024, 512], [0, 8, 256, 8], [0, 4, 0, 2]]",81808,down,0,"[[0, 4, 2, 2], [0, 32, 16, 512], [0, 8, 1024, 8], [4, 4, 256, 2]]",81808
5,"[[0, 4, 2, 2], [0, 32, 16, 512], [0, 8, 1024, 8], [4, 4, 256, 2]]",81808,right,12,"[[0, 0, 4, 4], [0, 32, 16, 512], [0, 8, 1024, 8], [2, 8, 256, 2]]",81820
5,"[[0, 0, 4, 4], [0, 32, 16, 512], [0, 8, 1024, 8], [2, 8, 256, 2]]",81820,up,16,"[[2, 32, 4, 4], [0, 16, 16, 512], [0, 0, 1024, 8], [2, 0, 256, 2]]",81836
5,"[[2, 32, 4, 4], [0, 16, 16, 512], [0, 0, 1024, 8], [2, 0, 256, 2]]",81836,right,40,"[[0, 2, 32, 8], [0, 0, 32, 512], [0, 0, 1024, 8], [2, 2, 256, 2]]",81876
5,"[[0, 2, 32, 8], [0, 0, 32, 512], [0, 0, 1024, 8], [2, 2, 256, 2]]",81876,up,68,"[[2, 4, 64, 8], [0, 0, 1024, 512], [0, 0, 256, 8], [0, 2, 0, 2]]",81944
5,"[[2, 4, 64, 8], [0, 0, 1024, 512], [0, 0, 256, 8], [0, 2, 0, 2]]",81944,right,4,"[[2, 4, 64, 8], [0, 0, 1024, 512], [0, 0, 256, 8], [0, 0, 2, 4]]",81948
5,"[[2, 4, 64, 8], [0, 0, 1024, 512], [0, 0, 256, 8], [0, 0, 2, 4]]",81948,up,0,"[[2, 4, 64, 8], [0, 0, 1024, 512], [0, 0, 256, 8], [0, 4, 2, 4]]",81948
5,"[[2, 4, 64, 8], [0, 0, 1024, 512], [0, 0, 256, 8], [0, 4, 2, 4]]",81948,down,8,"[[0, 0, 64, 8], [0, 0, 1024, 512], [0, 2, 256, 8], [2, 8, 2, 4]]",81956
5,"[[0, 0, 64, 8], [0, 0, 1024, 512], [0, 2, 256, 8], [2, 8, 2, 4]]",81956,left,0,"[[64, 8, 0, 0], [1024, 512, 0, 0], [2, 256, 8, 2], [2, 8, 2, 4]]",81956
5,"[[64, 8, 0, 0], [1024, 512, 0, 0], [2, 256, 8, 2], [2, 8, 2, 4]]",81956,up,4,"[[64, 8, 8, 2], [1024, 512, 2, 4], [4, 256, 2, 0], [0, 8, 0, 0]]",81960
5,"[[64, 8, 8, 2], [1024, 512, 2, 4], [4, 256, 2, 0], [0, 8, 0, 0]]",81960,left,16,"[[64, 16, 2, 0], [1024, 512, 2, 4], [4, 256, 2, 0], [8, 2, 0, 0]]",81976
5,"[[64, 16, 2, 0], [1024, 512, 2, 4], [4, 256, 2, 0], [8, 2, 0, 0]]",81976,up,4,"[[64, 16, 4, 4], [1024, 512, 2, 0], [4, 256, 0, 2], [8, 2, 0, 0]]",81980
5,"[[64, 16, 4, 4], [1024, 512, 2, 0], [4, 256, 0, 2], [8, 2, 0, 0]]",81980,left,8,"[[64, 16, 8, 0], [1024, 512, 2, 2], [4, 256, 2, 0], [8, 2, 0, 0]]",81988
5,"[[64, 16, 8, 0], [1024, 512, 2, 2], [4, 256, 2, 0], [8, 2, 0, 0]]",81988,right,4,"[[0, 64, 16, 8], [0, 1024, 512, 4], [2, 4, 256, 2], [0, 0, 8, 2]]",81992
5,"[[0, 64, 16, 8], [0, 1024, 512, 4], [2, 4, 256, 2], [0, 0, 8, 2]]",81992,up,4,"[[2, 64, 16, 8], [4, 1024, 512, 4], [0, 4, 256, 4], [0, 0, 8, 0]]",81996
5,"[[2, 64, 16, 8], [4, 1024, 512, 4], [0, 4, 256, 4], [0, 0, 8, 0]]",81996,up,8,"[[2, 64, 16, 8], [4, 1024, 512, 8], [2, 4, 256, 0], [0, 0, 8, 0]]",82004
5,"[[2, 64, 16, 8], [4, 1024, 512, 8], [2, 4, 256, 0], [0, 0, 8, 0]]",82004,up,16,"[[2, 64, 16, 16], [4, 1024, 512, 0], [2, 4, 256, 0], [2, 0, 8, 0]]",82020
5,"[[2, 64, 16, 16], [4, 1024, 512, 0], [2, 4, 256, 0], [2, 0, 8, 0]]",82020,left,32,"[[2, 64, 32, 0], [4, 1024, 512, 0], [2, 4, 256, 4], [2, 8, 0, 0]]",82052
5,"[[2, 64, 32, 0], [4, 1024, 512, 0], [2, 4, 256, 4], [2, 8, 0, 0]]",82052,up,4,"[[2, 64, 32, 4], [4, 1024, 512, 0], [4, 4, 256, 0], [0, 8, 4, 0]]",82056
5,"[[2, 64, 32, 4], [4, 1024, 512, 0], [4, 4, 256, 0], [0, 8, 4, 0]]",82056,right,8,"[[2, 64, 32, 4], [0, 4, 1024, 512], [0, 0, 8, 256], [0, 2, 8, 4]]",82064
5,"[[2, 64, 32, 4], [0, 4, 1024, 512], [0, 0, 8, 256], [0, 2, 8, 4]]",82064,down,16,"[[0, 0, 0, 4], [0, 64, 32, 512], [2, 4, 1024, 256], [2, 2, 16, 4]]",82080
5,"[[0, 0, 0, 4], [0, 64, 32, 512], [2, 4, 1024, 256], [2, 2, 16, 4]]",82080,up,4,"[[4, 64, 32, 4], [0, 4, 1024, 512], [0, 2, 16, 256], [0, 4, 0, 4]]",82084
5,"[[4, 64, 32, 4], [0, 4, 1024, 512], [0, 2, 16, 256], [0, 4, 0, 4]]",82084,right,8,"[[4, 64, 32, 4], [0, 4, 1024, 512], [0, 2, 16, 256], [0, 4, 0, 8]]",82092
5,"[[4, 64, 32, 4], [0, 4, 1024, 512], [0, 2, 16, 256], [0, 4, 0, 8]]",82092,up,0,"[[4, 64, 32, 4], [0, 4, 1024, 512], [2, 2, 16, 256], [0, 4, 0, 8]]",82092
5,"[[4, 64, 32, 4], [0, 4, 1024, 512], [2, 2, 16, 256], [0, 4, 0, 8]]",82092,left,4,"[[4, 64, 32, 4], [4, 1024, 512, 0], [4, 16, 256, 0], [4, 8, 2, 0]]",82096
5,"[[4, 64, 32, 4], [4, 1024, 512, 0], [4, 16, 256, 0], [4, 8, 2, 0]]",82096,down,16,"[[0, 64, 32, 0], [4, 1024, 512, 0], [8, 16, 256, 0], [8, 8, 2, 4]]",82112
5,"[[0, 64, 32, 0], [4, 1024, 512, 0], [8, 16, 256, 0], [8, 8, 2, 4]]",82112,right,16,"[[0, 0, 64, 32], [0, 4, 1024, 512], [2, 8, 16, 256], [0, 16, 2, 4]]",82128
5,"[[0, 0, 64, 32], [0, 4, 1024, 512], [2, 8, 16, 256], [0, 16, 2, 4]]",82128,up,0,"[[2, 4, 64, 32], [2, 8, 1024, 512], [0, 16, 16, 256], [0, 0, 2, 4]]",82128
5,"[[2, 4, 64, 32], [2, 8, 1024, 512], [0, 16, 16, 256], [0, 0, 2, 4]]",82128,right,32,"[[2, 4, 64, 32], [2, 8, 1024, 512], [0, 2, 32, 256], [0, 0, 2, 4]]",82160
5,"[[2, 4, 64, 32], [2, 8, 1024, 512], [0, 2, 32, 256], [0, 0, 2, 4]]",82160,up,4,"[[4, 4, 64, 32], [0, 8, 1024, 512], [4, 2, 32, 256], [0, 0, 2, 4]]",82164
5,"[[4, 4, 64, 32], [0, 8, 1024, 512], [4, 2, 32, 256], [0, 0, 2, 4]]",82164,right,8,"[[0, 8, 64, 32], [0, 8, 1024, 512], [4, 2, 32, 256], [2, 0, 2, 4]]",82172
5,"[[0, 8, 64, 32], [0, 8, 1024, 512], [4, 2, 32, 256], [2, 0, 2, 4]]",82172,left,4,"[[8, 64, 32, 0], [8, 1024, 512, 0], [4, 2, 32, 256], [4, 4, 4, 0]]",82176
5,"[[8, 64, 32, 0], [8, 1024, 512, 0], [4, 2, 32, 256], [4, 4, 4, 0]]",82176,down,24,"[[0, 64, 32, 0], [4, 1024, 512, 0], [16, 2, 32, 0], [8, 4, 4, 256]]",82200
5,"[[0, 64, 32, 0], [4, 1024, 512, 0], [16, 2, 32, 0], [8, 4, 4, 256]]",82200,left,8,"[[64, 32, 2, 0], [4, 1024, 512, 0], [16, 2, 32, 0], [8, 8, 256, 0]]",82208
5,"[[64, 32, 2, 0], [4, 1024, 512, 0], [16, 2, 32, 0], [8, 8, 256, 0]]",82208,left,16,"[[64, 32, 2, 0], [4, 1024, 512, 0], [16, 2, 32, 0], [16, 256, 0, 4]]",82224
5,"[[64, 32, 2, 0], [4, 1024, 512, 0], [16, 2, 32, 0], [16, 256, 0, 4]]",82224,down,32,"[[4, 32, 0, 0], [64, 1024, 2, 0], [4, 2, 512, 0], [32, 256, 32, 4]]",82256
5,"[[4, 32, 0, 0], [64, 1024, 2, 0], [4, 2, 512, 0], [32, 256, 32, 4]]",82256,down,0,"[[4, 32, 0, 0], [64, 1024, 2, 2], [4, 2, 512, 0], [32, 256, 32, 4]]",82256
5,"[[4, 32, 0, 0], [64, 1024, 2, 2], [4, 2, 512, 0], [32, 256, 32, 4]]",82256,left,4,"[[4, 32, 0, 0], [64, 1024, 4, 0], [4, 2, 512, 4], [32, 256, 32, 4]]",82260
5,"[[4, 32, 0, 0], [64, 1024, 4, 0], [4, 2, 512, 4], [32, 256, 32, 4]]",82260,up,8,"[[4, 32, 4, 8], [64, 1024, 512, 0], [4, 2, 32, 0], [32, 256, 0, 4]]",82268
5,"[[4, 32, 4, 8], [64, 1024, 512, 0], [4, 2, 32, 0], [32, 256, 0, 4]]",82268,up,0,"[[4, 32, 4, 8], [64, 1024, 512, 4], [4, 2, 32, 2], [32, 256, 0, 0]]",82268
5,"[[4, 32, 4, 8], [64, 1024, 512, 4], [4, 2, 32, 2], [32, 256, 0, 0]]",82268,right,0,"[[4, 32, 4, 8], [64, 1024, 512, 4], [4, 2, 32, 2], [0, 4, 32, 256]]",82268
5,"[[4, 32, 4, 8], [64, 1024, 512, 4], [4, 2, 32, 2], [0, 4, 32, 256]]",82268,down,64,"[[0, 32, 2, 8], [4, 1024, 4, 4], [64, 2, 512, 2], [4, 4, 64, 256]]",82332
5,"[[0, 32, 2, 8], [4, 1024, 4, 4], [64, 2, 512, 2], [4, 4, 64, 256]]",82332,left,16,"[[32, 2, 8, 2], [4, 1024, 8, 0], [64, 2, 512, 2], [8, 64, 256, 0]]",82348
5,"[[32, 2, 8, 2], [4, 1024, 8, 0], [64, 2, 512, 2], [8, 64, 256, 0]]",82348,down,20,"[[32, 2, 0, 0], [4, 1024, 16, 0], [64, 2, 512, 4], [8, 64, 256, 4]]",82368
5,"[[32, 2, 0, 0], [4, 1024, 16, 0], [64, 2, 512, 4], [8, 64, 256, 4]]",82368,down,8,"[[32, 2, 0, 0], [4, 1024, 16, 0], [64, 2, 512, 2], [8, 64, 256, 8]]",82376
5,"[[32, 2, 0, 0], [4, 1024, 16, 0], [64, 2, 512, 2], [8, 64, 256, 8]]",82376,right,0,"[[2, 0, 32, 2], [0, 4, 1024, 16], [64, 2, 512, 2], [8, 64, 256, 8]]",82376
5,"[[2, 0, 32, 2], [0, 4, 1024, 16], [64, 2, 512, 2], [8, 64, 256, 8]]",82376,down,0,"[[0, 4, 32, 2], [2, 4, 1024, 16], [64, 2, 512, 2], [8, 64, 256, 8]]",82376
5,"[[0, 4, 32, 2], [2, 4, 1024, 16], [64, 2, 512, 2], [8, 64, 256, 8]]",82376,down,8,"[[2, 0, 32, 2], [2, 8, 1024, 16], [64, 2, 512, 2], [8, 64, 256, 8]]",82384
5,"[[2, 0, 32, 2], [2, 8, 1024, 16], [64, 2, 512, 2], [8, 64, 256, 8]]",82384,up,4,"[[4, 8, 32, 2], [64, 2, 1024, 16], [8, 64, 512, 2], [0, 4, 256, 8]]",82388
5,"[[4, 8, 32, 2], [64, 2, 1024, 16], [8, 64, 512, 2], [0, 4, 256, 8]]",82388,down,0,"[[2, 8, 32, 2], [4, 2, 1024, 16], [64, 64, 512, 2], [8, 4, 256, 8]]",82388
5,"[[2, 8, 32, 2], [4, 2, 1024, 16], [64, 64, 512, 2], [8, 4, 256, 8]]",82388,right,128,"[[2, 8, 32, 2], [4, 2, 1024, 16], [4, 128, 512, 2], [8, 4, 256, 8]]",82516
5,"[[2, 8, 32, 2], [4, 2, 1024, 16], [4, 128, 512, 2], [8, 4, 256, 8]]",82516,down,8,"[[2, 8, 32, 2], [2, 2, 1024, 16], [8, 128, 512, 2], [8, 4, 256, 8]]",82524
5,"[[2, 8, 32, 2], [2, 2, 1024, 16], [8, 128, 512, 2], [8, 4, 256, 8]]",82524,down,20,"[[0, 8, 32, 2], [4, 2, 1024, 16], [4, 128, 512, 2], [16, 4, 256, 8]]",82544
5,"[[0, 8, 32, 2], [4, 2, 1024, 16], [4, 128, 512, 2], [16, 4, 256, 8]]",82544,up,8,"[[8, 8, 32, 2], [16, 2, 1024, 16], [2, 128, 512, 2], [0, 4, 256, 8]]",82552
5,"[[8, 8, 32, 2], [16, 2, 1024, 16], [2, 128, 512, 2], [0, 4, 256, 8]]",82552,left,16,"[[16, 32, 2, 2], [16, 2, 1024, 16], [2, 128, 512, 2], [4, 256, 8, 0]]",82568
5,"[[16, 32, 2, 2], [16, 2, 1024, 16], [2, 128, 512, 2], [4, 256, 8, 0]]",82568,up,32,"[[32, 32, 2, 2], [2, 2, 1024, 16], [4, 128, 512, 2], [2, 256, 8, 0]]",82600
5,"[[32, 32, 2, 2], [2, 2, 1024, 16], [4, 128, 512, 2], [2, 256, 8, 0]]",82600,left,72,"[[64, 4, 0, 0], [4, 1024, 16, 2], [4, 128, 512, 2], [2, 256, 8, 0]]",82672
5,"[[64, 4, 0, 0], [4, 1024, 16, 2], [4, 128, 512, 2], [2, 256, 8, 0]]",82672,right,0,"[[4, 0, 64, 4], [4, 1024, 16, 2], [4, 128, 512, 2], [0, 2, 256, 8]]",82672
5,"[[4, 0, 64, 4], [4, 1024, 16, 2], [4, 128, 512, 2], [0, 2, 256, 8]]",82672,down,12,"[[0, 0, 64, 2], [0, 1024, 16, 4], [4, 128, 512, 4], [8, 2, 256, 8]]",82684
5,"[[0, 0, 64, 2], [0, 1024, 16, 4], [4, 128, 512, 4], [8, 2, 256, 8]]",82684,up,8,"[[4, 1024, 64, 2], [8, 128, 16, 8], [0, 2, 512, 8], [0, 0, 256, 4]]",82692
5,"[[4, 1024, 64, 2], [8, 128, 16, 8], [0, 2, 512, 8], [0, 0, 256, 4]]",82692,up,16,"[[4, 1024, 64, 2], [8, 128, 16, 16], [0, 2, 512, 4], [4, 0, 256, 0]]",82708
5,"[[4, 1024, 64, 2], [8, 128, 16, 16], [0, 2, 512, 4], [4, 0, 256, 0]]",82708,right,32,"[[4, 1024, 64, 2], [0, 8, 128, 32], [4, 2, 512, 4], [0, 0, 4, 256]]",82740
5,"[[4, 1024, 64, 2], [0, 8, 128, 32], [4, 2, 512, 4], [0, 0, 4, 256]]",82740,up,8,"[[8, 1024, 64, 2], [0, 8, 128, 32], [4, 2, 512, 4], [0, 0, 4, 256]]",82748
5,"[[8, 1024, 64, 2], [0, 8, 128, 32], [4, 2, 512, 4], [0, 0, 4, 256]]",82748,left,0,"[[8, 1024, 64, 2], [8, 128, 32, 4], [4, 2, 512, 4], [4, 256, 0, 0]]",82748
5,"[[8, 1024, 64, 2], [8, 128, 32, 4], [4, 2, 512, 4], [4, 256, 0, 0]]",82748,up,32,"[[16, 1024, 64, 2], [8, 128, 32, 8], [0, 2, 512, 0], [2, 256, 0, 0]]",82780
5,"[[16, 1024, 64, 2], [8, 128, 32, 8], [0, 2, 512, 0], [2, 256, 0, 0]]",82780,right,0,"[[16, 1024, 64, 2], [8, 128, 32, 8], [0, 4, 2, 512], [0, 0, 2, 256]]",82780
5,"[[16, 1024, 64, 2], [8, 128, 32, 8], [0, 4, 2, 512], [0, 0, 2, 256]]",82780,down,4,"[[0, 0, 0, 2], [4, 1024, 64, 8], [16, 128, 32, 512], [8, 4, 4, 256]]",82784
5,"[[0, 0, 0, 2], [4, 1024, 64, 8], [16, 128, 32, 512], [8, 4, 4, 256]]",82784,left,8,"[[2, 0, 0, 4], [4, 1024, 64, 8], [16, 128, 32, 512], [8, 8, 256, 0]]",82792
5,"[[2, 0, 0, 4], [4, 1024, 64, 8], [16, 128, 32, 512], [8, 8, 256, 0]]",82792,left,16,"[[2, 4, 0, 0], [4, 1024, 64, 8], [16, 128, 32, 512], [16, 256, 4, 0]]",82808
5,"[[2, 4, 0, 0], [4, 1024, 64, 8], [16, 128, 32, 512], [16, 256, 4, 0]]",82808,up,32,"[[2, 4, 64, 8], [4, 1024, 32, 512], [32, 128, 4, 4], [0, 256, 0, 0]]",82840
5,"[[2, 4, 64, 8], [4, 1024, 32, 512], [32, 128, 4, 4], [0, 256, 0, 0]]",82840,right,8,"[[2, 4, 64, 8], [4, 1024, 32, 512], [0, 32, 128, 8], [4, 0, 0, 256]]",82848
5,"[[2, 4, 64, 8], [4, 1024, 32, 512], [0, 32, 128, 8], [4, 0, 0, 256]]",82848,down,8,"[[0, 0, 0, 8], [4, 4, 64, 512], [2, 1024, 32, 8], [8, 32, 128, 256]]",82856
5,"[[0, 0, 0, 8], [4, 4, 64, 512], [2, 1024, 32, 8], [8, 32, 128, 256]]",82856,left,8,"[[8, 4, 0, 0], [8, 64, 512, 0], [2, 1024, 32, 8], [8, 32, 128, 256]]",82864
5,"[[8, 4, 0, 0], [8, 64, 512, 0], [2, 1024, 32, 8], [8, 32, 128, 256]]",82864,down,16,"[[0, 4, 0, 4], [16, 64, 512, 0], [2, 1024, 32, 8], [8, 32, 128, 256]]",82880
5,"[[0, 4, 0, 4], [16, 64, 512, 0], [2, 1024, 32, 8], [8, 32, 128, 256]]",82880,right,8,"[[2, 0, 0, 8], [0, 16, 64, 512], [2, 1024, 32, 8], [8, 32, 128, 256]]",82888
5,"[[2, 0, 0, 8], [0, 16, 64, 512], [2, 1024, 32, 8], [8, 32, 128, 256]]",82888,right,0,"[[0, 2, 2, 8], [0, 16, 64, 512], [2, 1024, 32, 8], [8, 32, 128, 256]]",82888
5,"[[0, 2, 2, 8], [0, 16, 64, 512], [2, 1024, 32, 8], [8, 32, 128, 256]]",82888,right,4,"[[4, 0, 4, 8], [0, 16, 64, 512], [2, 1024, 32, 8], [8, 32, 128, 256]]",82892
5,"[[4, 0, 4, 8], [0, 16, 64, 512], [2, 1024, 32, 8], [8, 32, 128, 256]]",82892,up,0,"[[4, 16, 4, 8], [2, 1024, 64, 512], [8, 32, 32, 8], [0, 4, 128, 256]]",82892
5,"[[4, 16, 4, 8], [2, 1024, 64, 512], [8, 32, 32, 8], [0, 4, 128, 256]]",82892,right,64,"[[4, 16, 4, 8], [2, 1024, 64, 512], [4, 8, 64, 8], [0, 4, 128, 256]]",82956
5,"[[4, 16, 4, 8], [2, 1024, 64, 512], [4, 8, 64, 8], [0, 4, 128, 256]]",82956,down,128,"[[0, 16, 2, 8], [4, 1024, 4, 512], [2, 8, 128, 8], [4, 4, 128, 256]]",83084
5,"[[0, 16, 2, 8], [4, 1024, 4, 512], [2, 8, 128, 8], [4, 4, 128, 256]]",83084,down,256,"[[4, 16, 0, 8], [4, 1024, 2, 512], [2, 8, 4, 8], [4, 4, 256, 256]]",83340
5,"[[4, 16, 0, 8], [4, 1024, 2, 512], [2, 8, 4, 8], [4, 4, 256, 256]]",83340,left,520,"[[4, 16, 8, 0], [4, 1024, 2, 512], [2, 8, 4, 8], [8, 512, 2, 0]]",83860
5,"[[4, 16, 8, 0], [4, 1024, 2, 512], [2, 8, 4, 8], [8, 512, 2, 0]]",83860,up,8,"[[8, 16, 8, 512], [2, 1024, 2, 8], [8, 8, 4, 0], [2, 512, 2, 0]]",83868
5,"[[8, 16, 8, 512], [2, 1024, 2, 8], [8, 8, 4, 0], [2, 512, 2, 0]]",83868,left,16,"[[8, 16, 8, 512], [2, 1024, 2, 8], [16, 4, 4, 0], [2, 512, 2, 0]]",83884
5,"[[8, 16, 8, 512], [2, 1024, 2, 8], [16, 4, 4, 0], [2, 512, 2, 0]]",83884,right,8,"[[8, 16, 8, 512], [2, 1024, 2, 8], [0, 2, 16, 8], [0, 2, 512, 2]]",83892
5,"[[8, 16, 8, 512], [2, 1024, 2, 8], [0, 2, 16, 8], [0, 2, 512, 2]]",83892,down,20,"[[0, 0, 8, 0], [2, 16, 2, 512], [8, 1024, 16, 16], [2, 4, 512, 2]]",83912
5,"[[0, 0, 8, 0], [2, 16, 2, 512], [8, 1024, 16, 16], [2, 4, 512, 2]]",83912,left,32,"[[8, 0, 4, 0], [2, 16, 2, 512], [8, 1024, 32, 0], [2, 4, 512, 2]]",83944
5,"[[8, 0, 4, 0], [2, 16, 2, 512], [8, 1024, 32, 0], [2, 4, 512, 2]]",83944,left,0,"[[8, 4, 0, 4], [2, 16, 2, 512], [8, 1024, 32, 0], [2, 4, 512, 2]]",83944
5,"[[8, 4, 0, 4], [2, 16, 2, 512], [8, 1024, 32, 0], [2, 4, 512, 2]]",83944,up,0,"[[8, 4, 2, 4], [2, 16, 32, 512], [8, 1024, 512, 2], [2, 4, 0, 2]]",83944
5,"[[8, 4, 2, 4], [2, 16, 32, 512], [8, 1024, 512, 2], [2, 4, 0, 2]]",83944,down,4,"[[8, 4, 0, 2], [2, 16, 2, 4], [8, 1024, 32, 512], [2, 4, 512, 4]]",83948
5,"[[8, 4, 0, 2], [2, 16, 2, 4], [8, 1024, 32, 512], [2, 4, 512, 4]]",83948,up,0,"[[8, 4, 2, 2], [2, 16, 32, 4], [8, 1024, 512, 512], [2, 4, 2, 4]]",83948
5,"[[8, 4, 2, 2], [2, 16, 32, 4], [8, 1024, 512, 512], [2, 4, 2, 4]]",83948,left,1028,"[[8, 4, 4, 2], [2, 16, 32, 4], [8, 1024, 1024, 0], [2, 4, 2, 4]]",84976
5,"[[8, 4, 4, 2], [2, 16, 32, 4], [8, 1024, 1024, 0], [2, 4, 2, 4]]",84976,right,2056,"[[4, 8, 8, 2], [2, 16, 32, 4], [0, 0, 8, 2048], [2, 4, 2, 4]]",87032
8,"[[0, 0, 0, 0], [2, 0, 0, 2], [0, 0, 0, 0], [0, 0, 0, 0]]",113772,right,4,"[[0, 0, 2, 0], [0, 0, 0, 4], [0, 0, 0, 0], [0, 0, 0, 0]]",113776
8,"[[0, 0, 2, 0], [0, 0, 0, 4], [0, 0, 0, 0], [0, 0, 0, 0]]",113776,left,0,"[[2, 0, 0, 0], [4, 0, 0, 0], [4, 0, 0, 0], [0, 0, 0, 0]]",113776
8,"[[2, 0, 0, 0], [4, 0, 0, 0], [4, 0, 0, 0], [0, 0, 0, 0]]",113776,left,0,"[[2, 0, 0, 0], [4, 0, 4, 0], [4, 0, 0, 0], [0, 0, 0, 0]]",113776
8,"[[2, 0, 0, 0], [4, 0, 4, 0], [4, 0, 0, 0], [0, 0, 0, 0]]",113776,up,8,"[[2, 0, 4, 0], [8, 0, 0, 0], [0, 0, 0, 0], [0, 0, 4, 0]]",113784
8,"[[2, 0, 4, 0], [8, 0, 0, 0], [0, 0, 0, 0], [0, 0, 4, 0]]",113784,down,8,"[[0, 0, 0, 0], [2, 0, 0, 0], [2, 0, 0, 0], [8, 0, 8, 0]]",113792
8,"[[0, 0, 0, 0], [2, 0, 0, 0], [2, 0, 0, 0], [8, 0, 8, 0]]",113792,left,16,"[[0, 0, 0, 0], [2, 0, 0, 0], [2, 0, 2, 0], [16, 0, 0, 0]]",113808
8,"[[0, 0, 0, 0], [2, 0, 0, 0], [2, 0, 2, 0], [16, 0, 0, 0]]",113808,left,4,"[[0, 0, 0, 0], [2, 0, 0, 0], [4, 0, 0, 0], [16, 0, 4, 0]]",113812
8,"[[0, 0, 0, 0], [2, 0, 0, 0], [4, 0, 0, 0], [16, 0, 4, 0]]",113812,up,0,"[[2, 0, 4, 0], [4, 0, 0, 0], [16, 0, 0, 0], [0, 0, 0, 4]]",113812
8,"[[2, 0, 4, 0], [4, 0, 0, 0], [16, 0, 0, 0], [0, 0, 0, 4]]",113812,down,0,"[[2, 0, 0, 0], [2, 0, 0, 0], [4, 0, 0, 0], [16, 0, 4, 4]]",113812
8,"[[2, 0, 0, 0], [2, 0, 0, 0], [4, 0, 0, 0], [16, 0, 4, 4]]",113812,right,8,"[[0, 0, 0, 2], [0, 0, 0, 2], [0, 2, 0, 4], [0, 0, 16, 8]]",113820
8,"[[0, 0, 0, 2], [0, 0, 0, 2], [0, 2, 0, 4], [0, 0, 16, 8]]",113820,down,4,"[[0, 0, 0, 0], [0, 4, 0, 4], [0, 0, 0, 4], [0, 2, 16, 8]]",113824
8,"[[0, 0, 0, 0], [0, 4, 0, 4], [0, 0, 0, 4], [0, 2, 16, 8]]",113824,down,8,"[[0, 0, 0, 4], [0, 0, 0, 0], [0, 4, 0, 8], [0, 2, 16, 8]]",113832
8,"[[0, 0, 0, 4], [0, 0, 0, 0], [0, 4, 0, 8], [0, 2, 16, 8]]",113832,down,16,"[[0, 0, 4, 0], [0, 0, 0, 0], [0, 4, 0, 4], [0, 2, 16, 16]]",113848
8,"[[0, 0, 4, 0], [0, 0, 0, 0], [0, 4, 0, 4], [0, 2, 16, 16]]",113848,right,40,"[[0, 0, 0, 4], [0, 0, 0, 0], [0, 0, 0, 8], [0, 4, 2, 32]]",113888
8,"[[0, 0, 0, 4], [0, 0, 0, 0], [0, 0, 0, 8], [0, 4, 2, 32]]",113888,down,0,"[[0, 0, 0, 0], [0, 0, 0, 4], [4, 0, 0, 8], [0, 4, 2, 32]]",113888
8,"[[0, 0, 0, 0], [0, 0, 0, 4], [4, 0, 0, 8], [0, 4, 2, 32]]",113888,down,0,"[[0, 0, 0, 0], [0, 4, 0, 4], [0, 0, 0, 8], [4, 4, 2, 32]]",113888
8,"[[0, 0, 0, 0], [0, 4, 0, 4], [0, 0, 0, 8], [4, 4, 2, 32]]",113888,right,16,"[[0, 0, 0, 0], [0, 2, 0, 8], [0, 0, 0, 8], [0, 8, 2, 32]]",113904
8,"[[0, 0, 0, 0], [0, 2, 0, 8], [0, 0, 0, 8], [0, 8, 2, 32]]",113904,up,16,"[[0, 2, 2, 16], [0, 8, 0, 32], [0, 0, 0, 4], [0, 0, 0, 0]]",113920
8,"[[0, 2, 2, 16], [0, 8, 0, 32], [0, 0, 0, 4], [0, 0, 0, 0]]",113920,left,4,"[[4, 16, 0, 0], [8, 32, 0, 0], [4, 0, 0, 0], [0, 2, 0, 0]]",113924
8,"[[4, 16, 0, 0], [8, 32, 0, 0], [4, 0, 0, 0], [0, 2, 0, 0]]",113924,right,0,"[[0, 0, 4, 16], [0, 0, 8, 32], [0, 0, 0, 4], [0, 0, 2, 2]]",113924
8,"[[0, 0, 4, 16], [0, 0, 8, 32], [0, 0, 0, 4], [0, 0, 2, 2]]",113924,left,4,"[[4, 16, 0, 0], [8, 32, 0, 0], [4, 0, 2, 0], [4, 0, 0, 0]]",113928
8,"[[4, 16, 0, 0], [8, 32, 0, 0], [4, 0, 2, 0], [4, 0, 0, 0]]",113928,down,8,"[[0, 4, 0, 0], [4, 0, 0, 0], [8, 16, 0, 0], [8, 32, 2, 0]]",113936
8,"[[0, 4, 0, 0], [4, 0, 0, 0], [8, 16, 0, 0], [8, 32, 2, 0]]",113936,up,16,"[[4, 4, 2, 0], [16, 16, 0, 0], [2, 32, 0, 0], [0, 0, 0, 0]]",113952
8,"[[4, 4, 2, 0], [16, 16, 0, 0], [2, 32, 0, 0], [0, 0, 0, 0]]",113952,right,40,"[[0, 0, 8, 2], [4, 0, 0, 32], [0, 0, 2, 32], [0, 0, 0, 0]]",113992
8,"[[0, 0, 8, 2], [4, 0, 0, 32], [0, 0, 2, 32], [0, 0, 0, 0]]",113992,up,64,"[[4, 0, 8, 2], [0, 0, 2, 64], [0, 0, 0, 0], [4, 0, 0, 0]]",114056
8,"[[4, 0, 8, 2], [0, 0, 2, 64], [0, 0, 0, 0], [4, 0, 0, 0]]",114056,up,8,"[[8, 0, 8, 2], [0, 0, 2, 64], [0, 0, 0, 0], [4, 0, 0, 0]]",114064
8,"[[8, 0, 8, 2], [0, 0, 2, 64], [0, 0, 0, 0], [4, 0, 0, 0]]",114064,right,16,"[[0, 0, 16, 2], [0, 0, 2, 64], [0, 0, 0, 0], [0, 4, 0, 4]]",114080
8,"[[0, 0, 16, 2], [0, 0, 2, 64], [0, 0, 0, 0], [0, 4, 0, 4]]",114080,right,8,"[[0, 0, 16, 2], [0, 0, 2, 64], [0, 0, 0, 0], [0, 4, 0, 8]]",114088
8,"[[0, 0, 16, 2], [0, 0, 2, 64], [0, 0, 0, 0], [0, 4, 0, 8]]",114088,right,0,"[[0, 0, 16, 2], [0, 0, 2, 64], [0, 0, 0, 4], [0, 0, 4, 8]]",114088
8,"[[0, 0, 16, 2], [0, 0, 2, 64], [0, 0, 0, 4], [0, 0, 4, 8]]",114088,up,0,"[[0, 0, 16, 2], [0, 0, 2, 64], [0, 2, 4, 4], [0, 0, 0, 8]]",114088
8,"[[0, 0, 16, 2], [0, 0, 2, 64], [0, 2, 4, 4], [0, 0, 0, 8]]",114088,right,8,"[[0, 0, 16, 2], [0, 0, 2, 64], [0, 0, 2, 8], [0, 0, 2, 8]]",114096
8,"[[0, 0, 16, 2], [0, 0, 2, 64], [0, 0, 2, 8], [0, 0, 2, 8]]",114096,up,20,"[[0, 0, 16, 2], [0, 0, 4, 64], [0, 0, 2, 16], [0, 0, 0, 2]]",114116
8,"[[0, 0, 16, 2], [0, 0, 4, 64], [0, 0, 2, 16], [0, 0, 0, 2]]",114116,down,0,"[[0, 4, 0, 2], [0, 0, 16, 64], [0, 0, 4, 16], [0, 0, 2, 2]]",114116
8,"[[0, 4, 0, 2], [0, 0, 16, 64], [0, 0, 4, 16], [0, 0, 2, 2]]",114116,right,4,"[[0, 0, 4, 2], [0, 0, 16, 64], [0, 0, 4, 16], [4, 0, 0, 4]]",114120
8,"[[0, 0, 4, 2], [0, 0, 16, 64], [0, 0, 4, 16], [4, 0, 0, 4]]",114120,down,0,"[[0, 0, 2, 2], [0, 0, 4, 64], [0, 0, 16, 16], [4, 0, 4, 4]]",114120
8,"[[0, 0, 2, 2], [0, 0, 4, 64], [0, 0, 16, 16], [4, 0, 4, 4]]",114120,right,44,"[[0, 0, 0, 4], [4, 0, 4, 64], [0, 0, 0, 32], [0, 0, 4, 8]]",114164
8,"[[0, 0, 0, 4], [4, 0, 4, 64], [0, 0, 0, 32], [0, 0, 4, 8]]",114164,down,8,"[[0, 0, 0, 4], [0, 0, 0, 64], [0, 0, 0, 32], [4, 4, 8, 8]]",114172
8,"[[0, 0, 0, 4], [0, 0, 0, 64], [0, 0, 0, 32], [4, 4, 8, 8]]",114172,right,24,"[[0, 2, 0, 4], [0, 0, 0, 64], [0, 0, 0, 32], [0, 0, 8, 16]]",114196
8,"[[0, 2, 0, 4], [0, 0, 0, 64], [0, 0, 0, 32], [0, 0, 8, 16]]",114196,down,0,"[[0, 2, 0, 4], [0, 0, 0, 64], [0, 0, 0, 32], [0, 2, 8, 16]]",114196
8,"[[0, 2, 0, 4], [0, 0, 0, 64], [0, 0, 0, 32], [0, 2, 8, 16]]",114196,up,4,"[[0, 4, 8, 4], [0, 0, 0, 64], [0, 0, 0, 32], [0, 2, 0, 16]]",114200
8,"[[0, 4, 8, 4], [0, 0, 0, 64], [0, 0, 0, 32], [0, 2, 0, 16]]",114200,up,0,"[[0, 4, 8, 4], [0, 2, 0, 64], [0, 0, 0, 32], [4, 0, 0, 16]]",114200
8,"[[0, 4, 8, 4], [0, 2, 0, 64], [0, 0, 0, 32], [4, 0, 0, 16]]",114200,up,0,"[[4, 4, 8, 4], [4, 2, 0, 64], [0, 0, 0, 32], [0, 0, 0, 16]]",114200
8,"[[4, 4, 8, 4], [4, 2, 0, 64], [0, 0, 0, 32], [0, 0, 0, 16]]",114200,left,8,"[[8, 8, 4, 0], [4, 2, 64, 0], [32, 0, 4, 0], [16, 0, 0, 0]]",114208
8,"[[8, 8, 4, 0], [4, 2, 64, 0], [32, 0, 4, 0], [16, 0, 0, 0]]",114208,right,16,"[[0, 0, 16, 4], [0, 4, 2, 64], [0, 0, 32, 4], [0, 0, 4, 16]]",114224
8,"[[0, 0, 16, 4], [0, 4, 2, 64], [0, 0, 32, 4], [0, 0, 4, 16]]",114224,up,0,"[[0, 4, 16, 4], [0, 0, 2, 64], [0, 0, 32, 4], [2, 0, 4, 16]]",114224
8,"[[0, 4, 16, 4], [0, 0, 2, 64], [0, 0, 32, 4], [2, 0, 4, 16]]",114224,up,0,"[[2, 4, 16, 4], [0, 4, 2, 64], [0, 0, 32, 4], [0, 0, 4, 16]]",114224
8,"[[2, 4, 16, 4], [0, 4, 2, 64], [0, 0, 32, 4], [0, 0, 4, 16]]",114224,down,8,"[[0, 0, 16, 4], [2, 0, 2, 64], [0, 0, 32, 4], [2, 8, 4, 16]]",114232
8,"[[0, 0, 16, 4], [2, 0, 2, 64], [0, 0, 32, 4], [2, 8, 4, 16]]",114232,up,4,"[[4, 8, 16, 4], [0, 0, 2, 64], [0, 0, 32, 4], [2, 0, 4, 16]]",114236
8,"[[4, 8, 16, 4], [0, 0, 2, 64], [0, 0, 32, 4], [2, 0, 4, 16]]",114236,left,0,"[[4, 8, 16, 4], [2, 64, 2, 0], [32, 4, 0, 0], [2, 4, 16, 0]]",114236
8,"[[4, 8, 16, 4], [2, 64, 2, 0], [32, 4, 0, 0], [2, 4, 16, 0]]",114236,down,8,"[[4, 0, 4, 0], [2, 8, 16, 0], [32, 64, 2, 0], [2, 8, 16, 4]]",114244
8,"[[4, 0, 4, 0], [2, 8, 16, 0], [32, 64, 2, 0], [2, 8, 16, 4]]",114244,left,8,"[[8, 0, 0, 2], [2, 8, 16, 0], [32, 64, 2, 0], [2, 8, 16, 4]]",114252
8,"[[8, 0, 0, 2], [2, 8, 16, 0], [32, 64, 2, 0], [2, 8, 16, 4]]",114252,right,0,"[[4, 0, 8, 2], [0, 2, 8, 16], [0, 32, 64, 2], [2, 8, 16, 4]]",114252
8,"[[4, 0, 8, 2], [0, 2, 8, 16], [0, 32, 64, 2], [2, 8, 16, 4]]",114252,down,16,"[[0, 2, 0, 2], [0, 2, 16, 16], [4, 32, 64, 2], [2, 8, 16, 4]]",114268
8,"[[0, 2, 0, 2], [0, 2, 16, 16], [4, 32, 64, 2], [2, 8, 16, 4]]",114268,left,36,"[[4, 2, 0, 0], [2, 32, 0, 0], [4, 32, 64, 2], [2, 8, 16, 4]]",114304
8,"[[4, 2, 0, 0], [2, 32, 0, 0], [4, 32, 64, 2], [2, 8, 16, 4]]",114304,down,64,"[[4, 4, 0, 0], [2, 2, 0, 0], [4, 64, 64, 2], [2, 8, 16, 4]]",114368
8,"[[4, 4, 0, 0], [2, 2, 0, 0], [4, 64, 64, 2], [2, 8, 16, 4]]",114368,left,140,"[[8, 0, 4, 0], [4, 0, 0, 0], [4, 128, 2, 0], [2, 8, 16, 4]]",114508
8,"[[8, 0, 4, 0], [4, 0, 0, 0], [4, 128, 2, 0], [2, 8, 16, 4]]",114508,up,8,"[[8, 128, 4, 4], [8, 8, 2, 0], [2, 4, 16, 0], [0, 0, 0, 0]]",114516
8,"[[8, 128, 4, 4], [8, 8, 2, 0], [2, 4, 16, 0], [0, 0, 0, 0]]",114516,right,24,"[[0, 8, 128, 8], [0, 2, 16, 2], [0, 2, 4, 16], [0, 0, 0, 0]]",114540
8,"[[0, 8, 128, 8], [0, 2, 16, 2], [0, 2, 4, 16], [0, 0, 0, 0]]",114540,down,4,"[[0, 0, 0, 0], [0, 4, 128, 8], [0, 8, 16, 2], [0, 4, 4, 16]]",114544
8,"[[0, 0, 0, 0], [0, 4, 128, 8], [0, 8, 16, 2], [0, 4, 4, 16]]",114544,left,8,"[[0, 0, 0, 0], [4, 128, 8, 0], [8, 16, 2, 0], [8, 16, 0, 2]]",114552
8,"[[0, 0, 0, 0], [4, 128, 8, 0], [8, 16, 2, 0], [8, 16, 0, 2]]",114552,down,48,"[[0, 0, 2, 0], [0, 0, 0, 0], [4, 128, 8, 0], [16, 32, 2, 2]]",114600
8,"[[0, 0, 2, 0], [0, 0, 0, 0], [4, 128, 8, 0], [16, 32, 2, 2]]",114600,left,4,"[[2, 4, 0, 0], [0, 0, 0, 0], [4, 128, 8, 0], [16, 32, 4, 0]]",114604
8,"[[2, 4, 0, 0], [0, 0, 0, 0], [4, 128, 8, 0], [16, 32, 4, 0]]",114604,left,0,"[[2, 4, 0, 0], [0, 0, 0, 4], [4, 128, 8, 0], [16, 32, 4, 0]]",114604
8,"[[2, 4, 0, 0], [0, 0, 0, 4], [4, 128, 8, 0], [16, 32, 4, 0]]",114604,right,0,"[[4, 0, 2, 4], [0, 0, 0, 4], [0, 4, 128, 8], [0, 16, 32, 4]]",114604
8,"[[4, 0, 2, 4], [0, 0, 0, 4], [0, 4, 128, 8], [0, 16, 32, 4]]",114604,up,8,"[[4, 4, 2, 8], [0, 16, 128, 8], [0, 0, 32, 4], [0, 2, 0, 0]]",114612
8,"[[4, 4, 2, 8], [0, 16, 128, 8], [0, 0, 32, 4], [0, 2, 0, 0]]",114612,up,16,"[[4, 4, 2, 16], [4, 16, 128, 4], [0, 2, 32, 0], [0, 0, 0, 0]]",114628
8,"[[4, 4, 2, 16], [4, 16, 128, 4], [0, 2, 32, 0], [0, 0, 0, 0]]",114628,left,8,"[[8, 2, 16, 4], [4, 16, 128, 4], [2, 32, 0, 0], [0, 0, 0, 0]]",114636
8,"[[8, 2, 16, 4], [4, 16, 128, 4], [2, 32, 0, 0], [0, 0, 0, 0]]",114636,down,8,"[[0, 2, 0, 0], [8, 2, 0, 0], [4, 16, 16, 0], [2, 32, 128, 8]]",114644
8,"[[0, 2, 0, 0], [8, 2, 0, 0], [4, 16, 16, 0], [2, 32, 128, 8]]",114644,left,32,"[[2, 0, 2, 0], [8, 2, 0, 0], [4, 32, 0, 0], [2, 32, 128, 8]]",114676
8,"[[2, 0, 2, 0], [8, 2, 0, 0], [4, 32, 0, 0], [2, 32, 128, 8]]",114676,down,64,"[[2, 0, 2, 0], [8, 0, 0, 0], [4, 2, 2, 0], [2, 64, 128, 8]]",114740
8,"[[2, 0, 2, 0], [8, 0, 0, 0], [4, 2, 2, 0], [2, 64, 128, 8]]",114740,right,8,"[[0, 0, 0, 4], [4, 0, 0, 8], [0, 0, 4, 4], [2, 64, 128, 8]]",114748
8,"[[0, 0, 0, 4], [4, 0, 0, 8], [0, 0, 4, 4], [2, 64, 128, 8]]",114748,left,8,"[[4, 0, 0, 0], [4, 8, 0, 4], [8, 0, 0, 0], [2, 64, 128, 8]]",114756
8,"[[4, 0, 0, 0], [4, 8, 0, 4], [8, 0, 0, 0], [2, 64, 128, 8]]",114756,down,8,"[[0, 0, 0, 0], [8, 0, 0, 0], [8, 8, 4, 4], [2, 64, 128, 8]]",114764
8,"[[0, 0, 0, 0], [8, 0, 0, 0], [8, 8, 4, 4], [2, 64, 128, 8]]",114764,right,24,"[[0, 0, 0, 0], [0, 0, 2, 8], [0, 0, 16, 8], [2, 64, 128, 8]]",114788
8,"[[0, 0, 0, 0], [0, 0, 2, 8], [0, 0, 16, 8], [2, 64, 128, 8]]",114788,down,16,"[[0, 0, 0, 0], [0, 0, 2, 0], [4, 0, 16, 8], [2, 64, 128, 16]]",114804
8,"[[0, 0, 0, 0], [0, 0, 2, 0], [4, 0, 16, 8], [2, 64, 128, 16]]",114804,up,0,"[[4, 64, 2, 8], [2, 0, 16, 16], [0, 4, 128, 0], [0, 0, 0, 0]]",114804
8,"[[4, 64, 2, 8], [2, 0, 16, 16], [0, 4, 128, 0], [0, 0, 0, 0]]",114804,right,32,"[[4, 64, 2, 8], [0, 0, 2, 32], [0, 0, 4, 128], [0, 2, 0, 0]]",114836
8,"[[4, 64, 2, 8], [0, 0, 2, 32], [0, 0, 4, 128], [0, 2, 0, 0]]",114836,up,4,"[[4, 64, 4, 8], [0, 2, 4, 32], [0, 0, 0, 128], [0, 0, 0, 2]]",114840
8,"[[4, 64, 4, 8], [0, 2, 4, 32], [0, 0, 0, 128], [0, 0, 0, 2]]",114840,up,8,"[[4, 64, 8, 8], [0, 2, 0, 32], [0, 0, 0, 128], [0, 2, 0, 2]]",114848
8,"[[4, 64, 8, 8], [0, 2, 0, 32], [0, 0, 0, 128], [0, 2, 0, 2]]",114848,right,20,"[[4, 4, 64, 16], [0, 0, 2, 32], [0, 0, 0, 128], [0, 0, 0, 4]]",114868
8,"[[4, 4, 64, 16], [0, 0, 2, 32], [0, 0, 0, 128], [0, 0, 0, 4]]",114868,right,8,"[[0, 8, 64, 16], [2, 0, 2, 32], [0, 0, 0, 128], [0, 0, 0, 4]]",114876
8,"[[0, 8, 64, 16], [2, 0, 2, 32], [0, 0, 0, 128], [0, 0, 0, 4]]",114876,right,4,"[[0, 8, 64, 16], [0, 0, 4, 32], [4, 0, 0, 128], [0, 0, 0, 4]]",114880
8,"[[0, 8, 64, 16], [0, 0, 4, 32], [4, 0, 0, 128], [0, 0, 0, 4]]",114880,down,0,"[[0, 0, 0, 16], [0, 0, 0, 32], [4, 0, 64, 128], [4, 8, 4, 4]]",114880
8,"[[0, 0, 0, 16], [0, 0, 0, 32], [4, 0, 64, 128], [4, 8, 4, 4]]",114880,left,8,"[[16, 0, 0, 0], [32, 0, 0, 0], [4, 64, 128, 0], [4, 8, 8, 2]]",114888
8,"[[16, 0, 0, 0], [32, 0, 0, 0], [4, 64, 128, 0], [4, 8, 8, 2]]",114888,right,16,"[[0, 0, 4, 16], [0, 0, 0, 32], [0, 4, 64, 128], [0, 4, 16, 2]]",114904
8,"[[0, 0, 4, 16], [0, 0, 0, 32], [0, 4, 64, 128], [0, 4, 16, 2]]",114904,down,8,"[[2, 0, 0, 16], [0, 0, 4, 32], [0, 0, 64, 128], [0, 8, 16, 2]]",114912
8,"[[2, 0, 0, 16], [0, 0, 4, 32], [0, 0, 64, 128], [0, 8, 16, 2]]",114912,down,0,"[[0, 0, 0, 16], [0, 0, 4, 32], [0, 4, 64, 128], [2, 8, 16, 2]]",114912
8,"[[0, 0, 0, 16], [0, 0, 4, 32], [0, 4, 64, 128], [2, 8, 16, 2]]",114912,up,0,"[[2, 4, 4, 16], [2, 8, 64, 32], [0, 0, 16, 128], [0, 0, 0, 2]]",114912
8,"[[2, 4, 4, 16], [2, 8, 64, 32], [0, 0, 16, 128], [0, 0, 0, 2]]",114912,left,8,"[[2, 8, 16, 0], [2, 8, 64, 32], [16, 128, 0, 0], [2, 0, 0, 4]]",114920
8,"[[2, 8, 16, 0], [2, 8, 64, 32], [16, 128, 0, 0], [2, 0, 0, 4]]",114920,up,20,"[[4, 16, 16, 32], [16, 128, 64, 4], [2, 0, 0, 0], [0, 4, 0, 0]]",114940
8,"[[4, 16, 16, 32], [16, 128, 64, 4], [2, 0, 0, 0], [0, 4, 0, 0]]",114940,left,32,"[[4, 32, 32, 2], [16, 128, 64, 4], [2, 0, 0, 0], [4, 0, 0, 0]]",114972
8,"[[4, 32, 32, 2], [16, 128, 64, 4], [2, 0, 0, 0], [4, 0, 0, 0]]",114972,right,64,"[[0, 4, 64, 2], [16, 128, 64, 4], [0, 0, 0, 2], [0, 0, 2, 4]]",115036
8,"[[0, 4, 64, 2], [16, 128, 64, 4], [0, 0, 0, 2], [0, 0, 2, 4]]",115036,down,128,"[[0, 0, 4, 2], [0, 0, 0, 4], [0, 4, 128, 2], [16, 128, 2, 4]]",115164
8,"[[0, 0, 4, 2], [0, 0, 0, 4], [0, 4, 128, 2], [16, 128, 2, 4]]",115164,up,0,"[[16, 4, 4, 2], [0, 128, 128, 4], [2, 0, 2, 2], [0, 0, 0, 4]]",115164
8,"[[16, 4, 4, 2], [0, 128, 128, 4], [2, 0, 2, 2], [0, 0, 0, 4]]",115164,left,268,"[[16, 8, 2, 0], [256, 4, 0, 0], [4, 2, 0, 0], [4, 2, 0, 0]]",115432
8,"[[16, 8, 2, 0], [256, 4, 0, 0], [4, 2, 0, 0], [4, 2, 0, 0]]",115432,down,12,"[[0, 0, 0, 0], [16, 8, 4, 0], [256, 4, 0, 0], [8, 4, 2, 0]]",115444
8,"[[0, 0, 0, 0], [16, 8, 4, 0], [256, 4, 0, 0], [8, 4, 2, 0]]",115444,up,8,"[[16, 8, 4, 0], [256, 8, 2, 0], [8, 2, 0, 0], [0, 0, 0, 0]]",115452
8,"[[16, 8, 4, 0], [256, 8, 2, 0], [8, 2, 0, 0], [0, 0, 0, 0]]",115452,up,16,"[[16, 16, 4, 0], [256, 2, 2, 0], [8, 0, 0, 0], [2, 0, 0, 0]]",115468
8,"[[16, 16, 4, 0], [256, 2, 2, 0], [8, 0, 0, 0], [2, 0, 0, 0]]",115468,right,36,"[[0, 0, 32, 4], [0, 0, 256, 4], [4, 0, 0, 8], [0, 0, 0, 2]]",115504
8,"[[0, 0, 32, 4], [0, 0, 256, 4], [4, 0, 0, 8], [0, 0, 0, 2]]",115504,up,8,"[[4, 0, 32, 8], [2, 0, 256, 8], [0, 0, 0, 2], [0, 0, 0, 0]]",115512
8,"[[4, 0, 32, 8], [2, 0, 256, 8], [0, 0, 0, 2], [0, 0, 0, 0]]",115512,down,16,"[[0, 0, 0, 0], [0, 0, 0, 0], [4, 4, 32, 16], [2, 0, 256, 2]]",115528
8,"[[0, 0, 0, 0], [0, 0, 0, 0], [4, 4, 32, 16], [2, 0, 256, 2]]",115528,right,8,"[[0, 0, 0, 0], [0, 2, 0, 0], [0, 8, 32, 16], [0, 2, 256, 2]]",115536
8,"[[0, 0, 0, 0], [0, 2, 0, 0], [0, 8, 32, 16], [0, 2, 256, 2]]",115536,up,0,"[[0, 2, 32, 16], [0, 8, 256, 2], [0, 2, 0, 0], [0, 0, 0, 2]]",115536
8,"[[0, 2, 32, 16], [0, 8, 256, 2], [0, 2, 0, 0], [0, 0, 0, 2]]",115536,down,4,"[[0, 0, 0, 0], [0, 2, 2, 0], [0, 8, 32, 16], [0, 2, 256, 4]]",115540
8,"[[0, 0, 0, 0], [0, 2, 2, 0], [0, 8, 32, 16], [0, 2, 256, 4]]",115540,left,4,"[[0, 0, 0, 2], [4, 0, 0, 0], [8, 32, 16, 0], [2, 256, 4, 0]]",115544
8,"[[0, 0, 0, 2], [4, 0, 0, 0], [8, 32, 16, 0], [2, 256, 4, 0]]",115544,right,0,"[[0, 0, 0, 2], [0, 0, 2, 4], [0, 8, 32, 16], [0, 2, 256, 4]]",115544
8,"[[0, 0, 0, 2], [0, 0, 2, 4], [0, 8, 32, 16], [0, 2, 256, 4]]",115544,left,0,"[[2, 0, 0, 0], [2, 4, 0, 0], [8, 32, 16, 0], [2, 256, 4, 4]]",115544
8,"[[2, 0, 0, 0], [2, 4, 0, 0], [8, 32, 16, 0], [2, 256, 4, 4]]",115544,down,4,"[[0, 4, 0, 0], [4, 4, 0, 0], [8, 32, 16, 0], [2, 256, 4, 4]]",115548
8,"[[0, 4, 0, 0], [4, 4, 0, 0], [8, 32, 16, 0], [2, 256, 4, 4]]",115548,left,16,"[[4, 2, 0, 0], [8, 0, 0, 0], [8, 32, 16, 0], [2, 256, 8, 0]]",115564
8,"[[4, 2, 0, 0], [8, 0, 0, 0], [8, 32, 16, 0], [2, 256, 8, 0]]",115564,down,16,"[[0, 0, 0, 0], [4, 2, 2, 0], [16, 32, 16, 0], [2, 256, 8, 0]]",115580
8,"[[0, 0, 0, 0], [4, 2, 2, 0], [16, 32, 16, 0], [2, 256, 8, 0]]",115580,left,4,"[[0, 0, 0, 0], [4, 4, 0, 0], [16, 32, 16, 0], [2, 256, 8, 4]]",115584
8,"[[0, 0, 0, 0], [4, 4, 0, 0], [16, 32, 16, 0], [2, 256, 8, 4]]",115584,up,0,"[[4, 4, 16, 4], [16, 32, 8, 0], [2, 256, 0, 0], [0, 2, 0, 0]]",115584
8,"[[4, 4, 16, 4], [16, 32, 8, 0], [2, 256, 0, 0], [0, 2, 0, 0]]",115584,right,8,"[[0, 8, 16, 4], [0, 16, 32, 8], [0, 2, 2, 256], [0, 0, 0, 2]]",115592
8,"[[0, 8, 16, 4], [0, 16, 32, 8], [0, 2, 2, 256], [0, 0, 0, 2]]",115592,down,0,"[[0, 0, 0, 4], [0, 8, 16, 8], [0, 16, 32, 256], [2, 2, 2, 2]]",115592
8,"[[0, 0, 0, 4], [0, 8, 16, 8], [0, 16, 32, 256], [2, 2, 2, 2]]",115592,down,0,"[[0, 0, 0, 4], [0, 8, 16, 8], [2, 16, 32, 256], [2, 2, 2, 2]]",115592
8,"[[0, 0, 0, 4], [0, 8, 16, 8], [2, 16, 32, 256], [2, 2, 2, 2]]",115592,left,8,"[[4, 0, 0, 0], [8, 16, 8, 4], [2, 16, 32, 256], [4, 4, 0, 0]]",115600
8,"[[4, 0, 0, 0], [8, 16, 8, 4], [2, 16, 32, 256], [4, 4, 0, 0]]",115600,down,32,"[[4, 0, 0, 2], [8, 0, 0, 0], [2, 32, 8, 4], [4, 4, 32, 256]]",115632
8,"[[4, 0, 0, 2], [8, 0, 0, 0], [2, 32, 8, 4], [4, 4, 32, 256]]",115632,left,8,"[[4, 2, 0, 0], [8, 0, 0, 4], [2, 32, 8, 4], [8, 32, 256, 0]]",115640
8,"[[4, 2, 0, 0], [8, 0, 0, 4], [2, 32, 8, 4], [8, 32, 256, 0]]",115640,down,72,"[[4, 0, 0, 0], [8, 0, 4, 0], [2, 2, 8, 0], [8, 64, 256, 8]]",115712
8,"[[4, 0, 0, 0], [8, 0, 4, 0], [2, 2, 8, 0], [8, 64, 256, 8]]",115712,right,4,"[[0, 0, 0, 4], [0, 0, 8, 4], [0, 2, 4, 8], [8, 64, 256, 8]]",115716
8,"[[0, 0, 0, 4], [0, 0, 8, 4], [0, 2, 4, 8], [8, 64, 256, 8]]",115716,up,24,"[[8, 2, 8, 8], [0, 64, 4, 16], [2, 0, 256, 0], [0, 0, 0, 0]]",115740
8,"[[8, 2, 8, 8], [0, 64, 4, 16], [2, 0, 256, 0], [0, 0, 0, 0]]",115740,right,16,"[[0, 8, 2, 16], [0, 64, 4, 16], [0, 0, 2, 256], [0, 0, 0, 4]]",115756
8,"[[0, 8, 2, 16], [0, 64, 4, 16], [0, 0, 2, 256], [0, 0, 0, 4]]",115756,up,32,"[[0, 8, 2, 32], [0, 64, 4, 256], [0, 0, 2, 4], [0, 0, 4, 0]]",115788
8,"[[0, 8, 2, 32], [0, 64, 4, 256], [0, 0, 2, 4], [0, 0, 4, 0]]",115788,left,0,"[[8, 2, 32, 0], [64, 4, 256, 2], [2, 4, 0, 0], [4, 0, 0, 0]]",115788
8,"[[8, 2, 32, 0], [64, 4, 256, 2], [2, 4, 0, 0], [4, 0, 0, 0]]",115788,down,8,"[[8, 0, 0, 0], [64, 2, 0, 0], [2, 2, 32, 0], [4, 8, 256, 2]]",115796
8,"[[8, 0, 0, 0], [64, 2, 0, 0], [2, 2, 32, 0], [4, 8, 256, 2]]",115796,left,4,"[[8, 0, 0, 0], [64, 2, 0, 2], [4, 32, 0, 0], [4, 8, 256, 2]]",115800
8,"[[8, 0, 0, 0], [64, 2, 0, 2], [4, 32, 0, 0], [4, 8, 256, 2]]",115800,down,12,"[[0, 0, 0, 0], [8, 2, 0, 0], [64, 32, 0, 2], [8, 8, 256, 4]]",115812
8,"[[0, 0, 0, 0], [8, 2, 0, 0], [64, 32, 0, 2], [8, 8, 256, 4]]",115812,right,16,"[[0, 0, 0, 0], [0, 0, 8, 2], [0, 64, 32, 2], [4, 16, 256, 4]]",115828
8,"[[0, 0, 0, 0], [0, 0, 8, 2], [0, 64, 32, 2], [4, 16, 256, 4]]",115828,down,4,"[[0, 0, 4, 0], [0, 0, 8, 0], [0, 64, 32, 4], [4, 16, 256, 4]]",115832
8,"[[0, 0, 4, 0], [0, 0, 8, 0], [0, 64, 32, 4], [4, 16, 256, 4]]",115832,right,0,"[[0, 0, 0, 4], [0, 4, 0, 8], [0, 64, 32, 4], [4, 16, 256, 4]]",115832
8,"[[0, 0, 0, 4], [0, 4, 0, 8], [0, 64, 32, 4], [4, 16, 256, 4]]",115832,up,8,"[[4, 4, 32, 4], [4, 64, 256, 8], [0, 16, 0, 8], [0, 0, 0, 0]]",115840
8,"[[4, 4, 32, 4], [4, 64, 256, 8], [0, 16, 0, 8], [0, 0, 0, 0]]",115840,down,24,"[[0, 0, 0, 2], [0, 4, 0, 0], [0, 64, 32, 4], [8, 16, 256, 16]]",115864
8,"[[0, 0, 0, 2], [0, 4, 0, 0], [0, 64, 32, 4], [8, 16, 256, 16]]",115864,up,0,"[[8, 4, 32, 2], [0, 64, 256, 4], [0, 16, 0, 16], [0, 0, 0, 2]]",115864
8,"[[8, 4, 32, 2], [0, 64, 256, 4], [0, 16, 0, 16], [0, 0, 0, 2]]",115864,right,32,"[[8, 4, 32, 2], [0, 64, 256, 4], [4, 0, 0, 32], [0, 0, 0, 2]]",115896
8,"[[8, 4, 32, 2], [0, 64, 256, 4], [4, 0, 0, 32], [0, 0, 0, 2]]",115896,down,0,"[[0, 0, 2, 2], [0, 0, 0, 4], [8, 4, 32, 32], [4, 64, 256, 2]]",115896
8,"[[0, 0, 2, 2], [0, 0, 0, 4], [8, 4, 32, 32], [4, 64, 256, 2]]",115896,left,68,"[[4, 0, 0, 0], [4, 0, 0, 0], [8, 4, 64, 4], [4, 64, 256, 2]]",115964
8,"[[4, 0, 0, 0], [4, 0, 0, 0], [8, 4, 64, 4], [4, 64, 256, 2]]",115964,up,8,"[[8, 4, 64, 4], [8, 64, 256, 2], [4, 0, 0, 2], [0, 0, 0, 0]]",115972
8,"[[8, 4, 64, 4], [8, 64, 256, 2], [4, 0, 0, 2], [0, 0, 0, 0]]",115972,up,20,"[[16, 4, 64, 4], [4, 64, 256, 4], [0, 0, 4, 0], [0, 0, 0, 0]]",115992
8,"[[16, 4, 64, 4], [4, 64, 256, 4], [0, 0, 4, 0], [0, 0, 0, 0]]",115992,up,8,"[[16, 4, 64, 8], [4, 64, 256, 4], [0, 0, 4, 0], [0, 0, 0, 0]]",116000
8,"[[16, 4, 64, 8], [4, 64, 256, 4], [0, 0, 4, 0], [0, 0, 0, 0]]",116000,right,0,"[[16, 4, 64, 8], [4, 64, 256, 4], [0, 0, 0, 4], [0, 0, 4, 0]]",116000
8,"[[16, 4, 64, 8], [4, 64, 256, 4], [0, 0, 0, 4], [0, 0, 4, 0]]",116000,down,8,"[[0, 0, 2, 0], [0, 0, 64, 0], [16, 4, 256, 8], [4, 64, 4, 8]]",116008
8,"[[0, 0, 2, 0], [0, 0, 64, 0], [16, 4, 256, 8], [4, 64, 4, 8]]",116008,up,16,"[[16, 4, 2, 16], [4, 64, 64, 0], [0, 0, 256, 0], [4, 0, 4, 0]]",116024
8,"[[16, 4, 2, 16], [4, 64, 64, 0], [0, 0, 256, 0], [4, 0, 4, 0]]",116024,right,136,"[[16, 4, 2, 16], [0, 0, 4, 128], [0, 0, 0, 256], [4, 0, 0, 8]]",116160
8,"[[16, 4, 2, 16], [0, 0, 4, 128], [0, 0, 0, 256], [4, 0, 0, 8]]",116160,down,0,"[[4, 0, 0, 16], [0, 0, 0, 128], [16, 0, 2, 256], [4, 4, 4, 8]]",116160
8,"[[4, 0, 0, 16], [0, 0, 0, 128], [16, 0, 2, 256], [4, 4, 4, 8]]",116160,right,8,"[[0, 0, 4, 16], [0, 4, 0, 128], [0, 16, 2, 256], [0, 4, 8, 8]]",116168
8,"[[0, 0, 4, 16], [0, 4, 0, 128], [0, 16, 2, 256], [0, 4, 8, 8]]",116168,left,16,"[[4, 16, 0, 0], [4, 128, 0, 0], [16, 2, 256, 0], [4, 16, 0, 4]]",116184
8,"[[4, 16, 0, 0], [4, 128, 0, 0], [16, 2, 256, 0], [4, 16, 0, 4]]",116184,up,8,"[[8, 16, 256, 4], [16, 128, 0, 0], [4, 2, 0, 4], [0, 16, 0, 0]]",116192
8,"[[8, 16, 256, 4], [16, 128, 0, 0], [4, 2, 0, 4], [0, 16, 0, 0]]",116192,up,8,"[[8, 16, 256, 8], [16, 128, 0, 0], [4, 2, 0, 0], [2, 16, 0, 0]]",116200
8,"[[8, 16, 256, 8], [16, 128, 0, 0], [4, 2, 0, 0], [2, 16, 0, 0]]",116200,right,0,"[[8, 16, 256, 8], [0, 0, 16, 128], [0, 0, 4, 2], [0, 4, 2, 16]]",116200
8,"[[8, 16, 256, 8], [0, 0, 16, 128], [0, 0, 4, 2], [0, 4, 2, 16]]",116200,up,0,"[[8, 16, 256, 8], [0, 4, 16, 128], [2, 0, 4, 2], [0, 0, 2, 16]]",116200
8,"[[8, 16, 256, 8], [0, 4, 16, 128], [2, 0, 4, 2], [0, 0, 2, 16]]",116200,left,0,"[[8, 16, 256, 8], [4, 16, 128, 0], [2, 4, 2, 0], [2, 16, 4, 0]]",116200
8,"[[8, 16, 256, 8], [4, 16, 128, 0], [2, 4, 2, 0], [2, 16, 4, 0]]",116200,up,36,"[[8, 32, 256, 8], [4, 4, 128, 2], [4, 16, 2, 0], [0, 0, 4, 0]]",116236
8,"[[8, 32, 256, 8], [4, 4, 128, 2], [4, 16, 2, 0], [0, 0, 4, 0]]",116236,down,8,"[[4, 0, 256, 0], [0, 32, 128, 0], [8, 4, 2, 8], [8, 16, 4, 2]]",116244
8,"[[4, 0, 256, 0], [0, 32, 128, 0], [8, 4, 2, 8], [8, 16, 4, 2]]",116244,down,16,"[[0, 2, 256, 0], [0, 32, 128, 0], [4, 4, 2, 8], [16, 16, 4, 2]]",116260
8,"[[0, 2, 256, 0], [0, 32, 128, 0], [4, 4, 2, 8], [16, 16, 4, 2]]",116260,right,40,"[[2, 0, 2, 256], [0, 0, 32, 128], [0, 8, 2, 8], [0, 32, 4, 2]]",116300
8,"[[2, 0, 2, 256], [0, 0, 32, 128], [0, 8, 2, 8], [0, 32, 4, 2]]",116300,up,0,"[[2, 8, 2, 256], [2, 32, 32, 128], [0, 0, 2, 8], [0, 0, 4, 2]]",116300
8,"[[2, 8, 2, 256], [2, 32, 32, 128], [0, 0, 2, 8], [0, 0, 4, 2]]",116300,left,64,"[[2, 8, 2, 256], [2, 64, 128, 0], [2, 8, 4, 0], [4, 2, 0, 0]]",116364
8,"[[2, 8, 2, 256], [2, 64, 128, 0], [2, 8, 4, 0], [4, 2, 0, 0]]",116364,down,4,"[[4, 8, 0, 0], [2, 64, 2, 0], [4, 8, 128, 0], [4, 2, 4, 256]]",116368
8,"[[4, 8, 0, 0], [2, 64, 2, 0], [4, 8, 128, 0], [4, 2, 4, 256]]",116368,up,8,"[[4, 8, 2, 256], [2, 64, 128, 0], [8, 8, 4, 0], [0, 2, 0, 2]]",116376
8,"[[4, 8, 2, 256], [2, 64, 128, 0], [8, 8, 4, 0], [0, 2, 0, 2]]",116376,right,20,"[[4, 8, 2, 256], [0, 2, 64, 128], [0, 0, 16, 4], [0, 0, 4, 4]]",116396
8,"[[4, 8, 2, 256], [0, 2, 64, 128], [0, 0, 16, 4], [0, 0, 4, 4]]",116396,up,8,"[[4, 8, 2, 256], [0, 2, 64, 128], [2, 0, 16, 8], [0, 0, 4, 0]]",116404
8,"[[4, 8, 2, 256], [0, 2, 64, 128], [2, 0, 16, 8], [0, 0, 4, 0]]",116404,down,0,"[[0, 0, 2, 2], [0, 0, 64, 256], [4, 8, 16, 128], [2, 2, 4, 8]]",116404
8,"[[0, 0, 2, 2], [0, 0, 64, 256], [4, 8, 16, 128], [2, 2, 4, 8]]",116404,left,8,"[[4, 0, 0, 2], [64, 256, 0, 0], [4, 8, 16, 128], [4, 4, 8, 0]]",116412
8,"[[4, 0, 0, 2], [64, 256, 0, 0], [4, 8, 16, 128], [4, 4, 8, 0]]",116412,left,8,"[[4, 2, 2, 0], [64, 256, 0, 0], [4, 8, 16, 128], [8, 8, 0, 0]]",116420
8,"[[4, 2, 2, 0], [64, 256, 0, 0], [4, 8, 16, 128], [8, 8, 0, 0]]",116420,down,16,"[[4, 0, 0, 0], [64, 2, 0, 0], [4, 256, 2, 2], [8, 16, 16, 128]]",116436
8,"[[4, 0, 0, 0], [64, 2, 0, 0], [4, 256, 2, 2], [8, 16, 16, 128]]",116436,right,36,"[[0, 0, 4, 4], [0, 0, 64, 2], [0, 4, 256, 4], [0, 8, 32, 128]]",116472
8,"[[0, 0, 4, 4], [0, 0, 64, 2], [0, 4, 256, 4], [0, 8, 32, 128]]",116472,right,8,"[[0, 0, 2, 8], [0, 0, 64, 2], [0, 4, 256, 4], [0, 8, 32, 128]]",116480
8,"[[0, 0, 2, 8], [0, 0, 64, 2], [0, 4, 256, 4], [0, 8, 32, 128]]",116480,right,0,"[[0, 2, 2, 8], [0, 0, 64, 2], [0, 4, 256, 4], [0, 8, 32, 128]]",116480
8,"[[0, 2, 2, 8], [0, 0, 64, 2], [0, 4, 256, 4], [0, 8, 32, 128]]",116480,right,4,"[[0, 0, 4, 8], [0, 4, 64, 2], [0, 4, 256, 4], [0, 8, 32, 128]]",116484
8,"[[0, 0, 4, 8], [0, 4, 64, 2], [0, 4, 256, 4], [0, 8, 32, 128]]",116484,down,8,"[[0, 2, 4, 8], [0, 0, 64, 2], [0, 8, 256, 4], [0, 8, 32, 128]]",116492
8,"[[0, 2, 4, 8], [0, 0, 64, 2], [0, 8, 256, 4], [0, 8, 32, 128]]",116492,down,16,"[[0, 4, 4, 8], [0, 0, 64, 2], [0, 2, 256, 4], [0, 16, 32, 128]]",116508
8,"[[0, 4, 4, 8], [0, 0, 64, 2], [0, 2, 256, 4], [0, 16, 32, 128]]",116508,right,8,"[[0, 4, 8, 8], [0, 0, 64, 2], [0, 2, 256, 4], [0, 16, 32, 128]]",116516
8,"[[0, 4, 8, 8], [0, 0, 64, 2], [0, 2, 256, 4], [0, 16, 32, 128]]",116516,left,16,"[[4, 16, 0, 0], [64, 2, 0, 0], [2, 256, 4, 0], [16, 32, 128, 4]]",116532
8,"[[4, 16, 0, 0], [64, 2, 0, 0], [2, 256, 4, 0], [16, 32, 128, 4]]",116532,left,0,"[[4, 16, 4, 0], [64, 2, 0, 0], [2, 256, 4, 0], [16, 32, 128, 4]]",116532
8,"[[4, 16, 4, 0], [64, 2, 0, 0], [2, 256, 4, 0], [16, 32, 128, 4]]",116532,down,8,"[[4, 16, 0, 0], [64, 2, 0, 0], [2, 256, 8, 2], [16, 32, 128, 4]]",116540
8,"[[4, 16, 0, 0], [64, 2, 0, 0], [2, 256, 8, 2], [16, 32, 128, 4]]",116540,right,0,"[[0, 4, 4, 16], [0, 0, 64, 2], [2, 256, 8, 2], [16, 32, 128, 4]]",116540
8,"[[0, 4, 4, 16], [0, 0, 64, 2], [2, 256, 8, 2], [16, 32, 128, 4]]",116540,up,4,"[[2, 4, 4, 16], [16, 256, 64, 4], [0, 32, 8, 4], [2, 0, 128, 0]]",116544
8,"[[2, 4, 4, 16], [16, 256, 64, 4], [0, 32, 8, 4], [2, 0, 128, 0]]",116544,right,8,"[[2, 2, 8, 16], [16, 256, 64, 4], [0, 32, 8, 4], [0, 0, 2, 128]]",116552
8,"[[2, 2, 8, 16], [16, 256, 64, 4], [0, 32, 8, 4], [0, 0, 2, 128]]",116552,down,8,"[[4, 0, 8, 0], [0, 2, 64, 16], [2, 256, 8, 8], [16, 32, 2, 128]]",116560
8,"[[4, 0, 8, 0], [0, 2, 64, 16], [2, 256, 8, 8], [16, 32, 2, 128]]",116560,right,16,"[[0, 0, 4, 8], [0, 2, 64, 16], [4, 2, 256, 16], [16, 32, 2, 128]]",116576
8,"[[0, 0, 4, 8], [0, 2, 64, 16], [4, 2, 256, 16], [16, 32, 2, 128]]",116576,down,36,"[[0, 0, 4, 0], [0, 4, 64, 8], [4, 4, 256, 32], [16, 32, 2, 128]]",116612
8,"[[0, 0, 4, 0], [0, 4, 64, 8], [4, 4, 256, 32], [16, 32, 2, 128]]",116612,left,8,"[[4, 0, 4, 0], [4, 64, 8, 0], [8, 256, 32, 0], [16, 32, 2, 128]]",116620
8,"[[4, 0, 4, 0], [4, 64, 8, 0], [8, 256, 32, 0], [16, 32, 2, 128]]",116620,up,8,"[[8, 64, 4, 128], [8, 256, 8, 0], [16, 32, 32, 2], [0, 0, 2, 0]]",116628
8,"[[8, 64, 4, 128], [8, 256, 8, 0], [16, 32, 32, 2], [0, 0, 2, 0]]",116628,left,64,"[[8, 64, 4, 128], [8, 256, 8, 0], [16, 64, 2, 0], [2, 4, 0, 0]]",116692
8,"[[8, 64, 4, 128], [8, 256, 8, 0], [16, 64, 2, 0], [2, 4, 0, 0]]",116692,down,16,"[[0, 64, 0, 0], [16, 256, 4, 4], [16, 64, 8, 0], [2, 4, 2, 128]]",116708
8,"[[0, 64, 0, 0], [16, 256, 4, 4], [16, 64, 8, 0], [2, 4, 2, 128]]",116708,right,8,"[[0, 0, 4, 64], [0, 16, 256, 8], [0, 16, 64, 8], [2, 4, 2, 128]]",116716
8,"[[0, 0, 4, 64], [0, 16, 256, 8], [0, 16, 64, 8], [2, 4, 2, 128]]",116716,down,48,"[[0, 0, 4, 0], [0, 4, 256, 64], [0, 32, 64, 16], [2, 4, 2, 128]]",116764
8,"[[0, 0, 4, 0], [0, 4, 256, 64], [0, 32, 64, 16], [2, 4, 2, 128]]",116764,down,0,"[[0, 0, 4, 2], [0, 4, 256, 64], [0, 32, 64, 16], [2, 4, 2, 128]]",116764
8,"[[0, 0, 4, 2], [0, 4, 256, 64], [0, 32, 64, 16], [2, 4, 2, 128]]",116764,up,0,"[[2, 4, 4, 2], [2, 32, 256, 64], [0, 4, 64, 16], [0, 0, 2, 128]]",116764
8,"[[2, 4, 4, 2], [2, 32, 256, 64], [0, 4, 64, 16], [0, 0, 2, 128]]",116764,down,4,"[[0, 2, 4, 2], [0, 4, 256, 64], [0, 32, 64, 16], [4, 4, 2, 128]]",116768
8,"[[0, 2, 4, 2], [0, 4, 256, 64], [0, 32, 64, 16], [4, 4, 2, 128]]",116768,up,0,"[[4, 2, 4, 2], [0, 4, 256, 64], [4, 32, 64, 16], [0, 4, 2, 128]]",116768
8,"[[4, 2, 4, 2], [0, 4, 256, 64], [4, 32, 64, 16], [0, 4, 2, 128]]",116768,down,8,"[[0, 2, 4, 2], [2, 4, 256, 64], [0, 32, 64, 16], [8, 4, 2, 128]]",116776
8,"[[0, 2, 4, 2], [2, 4, 256, 64], [0, 32, 64, 16], [8, 4, 2, 128]]",116776,down,0,"[[0, 2, 4, 2], [2, 4, 256, 64], [2, 32, 64, 16], [8, 4, 2, 128]]",116776
8,"[[0, 2, 4, 2], [2, 4, 256, 64], [2, 32, 64, 16], [8, 4, 2, 128]]",116776,down,4,"[[0, 2, 4, 2], [2, 4, 256, 64], [4, 32, 64, 16], [8, 4, 2, 128]]",116780
8,"[[0, 2, 4, 2], [2, 4, 256, 64], [4, 32, 64, 16], [8, 4, 2, 128]]",116780,up,0,"[[2, 2, 4, 2], [4, 4, 256, 64], [8, 32, 64, 16], [2, 4, 2, 128]]",116780
8,"[[2, 2, 4, 2], [4, 4, 256, 64], [8, 32, 64, 16], [2, 4, 2, 128]]",116780,left,12,"[[4, 4, 2, 4], [8, 256, 64, 0], [8, 32, 64, 16], [2, 4, 2, 128]]",116792
8,"[[4, 4, 2, 4], [8, 256, 64, 0], [8, 32, 64, 16], [2, 4, 2, 128]]",116792,up,144,"[[4, 4, 2, 4], [16, 256, 128, 16], [2, 32, 2, 128], [4, 4, 0, 0]]",116936
8,"[[4, 4, 2, 4], [16, 256, 128, 16], [2, 32, 2, 128], [4, 4, 0, 0]]",116936,right,16,"[[0, 8, 2, 4], [16, 256, 128, 16], [2, 32, 2, 128], [0, 2, 0, 8]]",116952
8,"[[0, 8, 2, 4], [16, 256, 128, 16], [2, 32, 2, 128], [0, 2, 0, 8]]",116952,right,0,"[[2, 8, 2, 4], [16, 256, 128, 16], [2, 32, 2, 128], [0, 0, 2, 8]]",116952
8,"[[2, 8, 2, 4], [16, 256, 128, 16], [2, 32, 2, 128], [0, 0, 2, 8]]",116952,down,4,"[[0, 4, 0, 4], [2, 8, 2, 16], [16, 256, 128, 128], [2, 32, 4, 8]]",116956
8,"[[0, 4, 0, 4], [2, 8, 2, 16], [16, 256, 128, 128], [2, 32, 4, 8]]",116956,left,264,"[[8, 0, 4, 0], [2, 8, 2, 16], [16, 256, 256, 0], [2, 32, 4, 8]]",117220
8,"[[8, 0, 4, 0], [2, 8, 2, 16], [16, 256, 256, 0], [2, 32, 4, 8]]",117220,right,512,"[[0, 0, 8, 4], [2, 8, 2, 16], [4, 0, 16, 512], [2, 32, 4, 8]]",117732
8,"[[0, 0, 8, 4], [2, 8, 2, 16], [4, 0, 16, 512], [2, 32, 4, 8]]",117732,up,0,"[[2, 8, 8, 4], [4, 32, 2, 16], [2, 0, 16, 512], [0, 2, 4, 8]]",117732
8,"[[2, 8, 8, 4], [4, 32, 2, 16], [2, 0, 16, 512], [0, 2, 4, 8]]",117732,right,16,"[[2, 2, 16, 4], [4, 32, 2, 16], [0, 2, 16, 512], [0, 2, 4, 8]]",117748
8,"[[2, 2, 16, 4], [4, 32, 2, 16], [0, 2, 16, 512], [0, 2, 4, 8]]",117748,down,4,"[[0, 0, 16, 4], [4, 2, 2, 16], [2, 32, 16, 512], [4, 4, 4, 8]]",117752
8,"[[0, 0, 16, 4], [4, 2, 2, 16], [2, 32, 16, 512], [4, 4, 4, 8]]",117752,left,12,"[[16, 4, 0, 0], [4, 4, 16, 0], [2, 32, 16, 512], [8, 4, 8, 2]]",117764
8,"[[16, 4, 0, 0], [4, 4, 16, 0], [2, 32, 16, 512], [8, 4, 8, 2]]",117764,down,40,"[[16, 0, 0, 0], [4, 8, 0, 4], [2, 32, 32, 512], [8, 4, 8, 2]]",117804
8,"[[16, 0, 0, 0], [4, 8, 0, 4], [2, 32, 32, 512], [8, 4, 8, 2]]",117804,left,64,"[[16, 0, 0, 4], [4, 8, 4, 0], [2, 64, 512, 0], [8, 4, 8, 2]]",117868
8,"[[16, 0, 0, 4], [4, 8, 4, 0], [2, 64, 512, 0], [8, 4, 8, 2]]",117868,up,0,"[[16, 8, 4, 4], [4, 64, 512, 2], [2, 4, 8, 4], [8, 0, 0, 0]]",117868
8,"[[16, 8, 4, 4], [4, 64, 512, 2], [2, 4, 8, 4], [8, 0, 0, 0]]",117868,right,8,"[[0, 16, 8, 8], [4, 64, 512, 2], [2, 4, 8, 4], [0, 4, 0, 8]]",117876
8,"[[0, 16, 8, 8], [4, 64, 512, 2], [2, 4, 8, 4], [0, 4, 0, 8]]",117876,right,16,"[[0, 0, 16, 16], [4, 64, 512, 2], [2, 4, 8, 4], [0, 2, 4, 8]]",117892
8,"[[0, 0, 16, 16], [4, 64, 512, 2], [2, 4, 8, 4], [0, 2, 4, 8]]",117892,left,32,"[[32, 0, 0, 0], [4, 64, 512, 2], [2, 4, 8, 4], [2, 4, 8, 2]]",117924
8,"[[32, 0, 0, 0], [4, 64, 512, 2], [2, 4, 8, 4], [2, 4, 8, 2]]",117924,down,28,"[[0, 0, 0, 0], [32, 4, 0, 2], [4, 64, 512, 4], [4, 8, 16, 2]]",117952
8,"[[0, 0, 0, 0], [32, 4, 0, 2], [4, 64, 512, 4], [4, 8, 16, 2]]",117952,down,8,"[[0, 0, 0, 0], [2, 4, 0, 2], [32, 64, 512, 4], [8, 8, 16, 2]]",117960
8,"[[0, 0, 0, 0], [2, 4, 0, 2], [32, 64, 512, 4], [8, 8, 16, 2]]",117960,left,16,"[[0, 0, 0, 0], [2, 4, 2, 0], [32, 64, 512, 4], [16, 16, 2, 4]]",117976
8,"[[0, 0, 0, 0], [2, 4, 2, 0], [32, 64, 512, 4], [16, 16, 2, 4]]",117976,left,32,"[[0, 2, 0, 0], [2, 4, 2, 0], [32, 64, 512, 4], [32, 2, 4, 0]]",118008
8,"[[0, 2, 0, 0], [2, 4, 2, 0], [32, 64, 512, 4], [32, 2, 4, 0]]",118008,down,64,"[[0, 2, 0, 2], [0, 4, 2, 0], [2, 64, 512, 0], [64, 2, 4, 4]]",118072
8,"[[0, 2, 0, 2], [0, 4, 2, 0], [2, 64, 512, 0], [64, 2, 4, 4]]",118072,right,12,"[[0, 4, 0, 4], [0, 0, 4, 2], [0, 2, 64, 512], [0, 64, 2, 8]]",118084
8,"[[0, 4, 0, 4], [0, 0, 4, 2], [0, 2, 64, 512], [0, 64, 2, 8]]",118084,down,0,"[[0, 4, 0, 4], [0, 4, 4, 2], [0, 2, 64, 512], [0, 64, 2, 8]]",118084
8,"[[0, 4, 0, 4], [0, 4, 4, 2], [0, 2, 64, 512], [0, 64, 2, 8]]",118084,up,8,"[[0, 8, 4, 4], [0, 2, 64, 2], [0, 64, 2, 512], [0, 4, 0, 8]]",118092
8,"[[0, 8, 4, 4], [0, 2, 64, 2], [0, 64, 2, 512], [0, 4, 0, 8]]",118092,down,0,"[[0, 8, 0, 4], [4, 2, 4, 2], [0, 64, 64, 512], [0, 4, 2, 8]]",118092
8,"[[0, 8, 0, 4], [4, 2, 4, 2], [0, 64, 64, 512], [0, 4, 2, 8]]",118092,left,128,"[[8, 4, 0, 0], [4, 2, 4, 2], [128, 512, 0, 2], [4, 2, 8, 0]]",118220
8,"[[8, 4, 0, 0], [4, 2, 4, 2], [128, 512, 0, 2], [4, 2, 8, 0]]",118220,up,4,"[[8, 4, 4, 4], [4, 2, 8, 0], [128, 512, 0, 0], [4, 2, 0, 2]]",118224
8,"[[8, 4, 4, 4], [4, 2, 8, 0], [128, 512, 0, 0], [4, 2, 0, 2]]",118224,right,12,"[[0, 8, 4, 8], [0, 4, 2, 8], [0, 0, 128, 512], [4, 0, 4, 4]]",118236
8,"[[0, 8, 4, 8], [0, 4, 2, 8], [0, 0, 128, 512], [4, 0, 4, 4]]",118236,down,16,"[[0, 0, 4, 0], [0, 0, 2, 16], [4, 8, 128, 512], [4, 4, 4, 4]]",118252
8,"[[0, 0, 4, 0], [0, 0, 2, 16], [4, 8, 128, 512], [4, 4, 4, 4]]",118252,left,16,"[[4, 0, 0, 0], [2, 16, 0, 4], [4, 8, 128, 512], [8, 8, 0, 0]]",118268
8,"[[4, 0, 0, 0], [2, 16, 0, 4], [4, 8, 128, 512], [8, 8, 0, 0]]",118268,down,16,"[[4, 0, 0, 0], [2, 2, 0, 0], [4, 16, 0, 4], [8, 16, 128, 512]]",118284
8,"[[4, 0, 0, 0], [2, 2, 0, 0], [4, 16, 0, 4], [8, 16, 128, 512]]",118284,down,32,"[[4, 0, 0, 0], [2, 0, 0, 4], [4, 2, 0, 4], [8, 32, 128, 512]]",118316
8,"[[4, 0, 0, 0], [2, 0, 0, 4], [4, 2, 0, 4], [8, 32, 128, 512]]",118316,right,0,"[[0, 0, 0, 4], [0, 0, 2, 4], [4, 4, 2, 4], [8, 32, 128, 512]]",118316
8,"[[0, 0, 0, 4], [0, 0, 2, 4], [4, 4, 2, 4], [8, 32, 128, 512]]",118316,left,8,"[[4, 4, 0, 0], [2, 4, 0, 0], [8, 2, 4, 0], [8, 32, 128, 512]]",118324
8,"[[4, 4, 0, 0], [2, 4, 0, 0], [8, 2, 4, 0], [8, 32, 128, 512]]",118324,up,24,"[[4, 8, 4, 512], [2, 2, 128, 0], [16, 32, 0, 0], [0, 4, 0, 0]]",118348
8,"[[4, 8, 4, 512], [2, 2, 128, 0], [16, 32, 0, 0], [0, 4, 0, 0]]",118348,right,4,"[[4, 8, 4, 512], [0, 4, 4, 128], [0, 0, 16, 32], [0, 0, 0, 4]]",118352
8,"[[4, 8, 4, 512], [0, 4, 4, 128], [0, 0, 16, 32], [0, 0, 0, 4]]",118352,up,8,"[[4, 8, 8, 512], [0, 4, 16, 128], [0, 0, 0, 32], [0, 2, 0, 4]]",118360
8,"[[4, 8, 8, 512], [0, 4, 16, 128], [0, 0, 0, 32], [0, 2, 0, 4]]",118360,left,16,"[[4, 16, 512, 0], [4, 16, 128, 0], [32, 0, 0, 4], [2, 4, 0, 0]]",118376
8,"[[4, 16, 512, 0], [4, 16, 128, 0], [32, 0, 0, 4], [2, 4, 0, 0]]",118376,down,40,"[[2, 0, 0, 0], [8, 0, 0, 0], [32, 32, 512, 0], [2, 4, 128, 4]]",118416
8,"[[2, 0, 0, 0], [8, 0, 0, 0], [32, 32, 512, 0], [2, 4, 128, 4]]",118416,right,64,"[[4, 0, 0, 2], [0, 0, 0, 8], [0, 0, 64, 512], [2, 4, 128, 4]]",118480
8,"[[4, 0, 0, 2], [0, 0, 0, 8], [0, 0, 64, 512], [2, 4, 128, 4]]",118480,up,0,"[[4, 4, 64, 2], [2, 2, 128, 8], [0, 0, 0, 512], [0, 0, 0, 4]]",118480
8,"[[4, 4, 64, 2], [2, 2, 128, 8], [0, 0, 0, 512], [0, 0, 0, 4]]",118480,right,12,"[[0, 8, 64, 2], [0, 4, 128, 8], [0, 0, 0, 512], [0, 0, 2, 4]]",118492
8,"[[0, 8, 64, 2], [0, 4, 128, 8], [0, 0, 0, 512], [0, 0, 2, 4]]",118492,up,0,"[[0, 8, 64, 2], [0, 4, 128, 8], [0, 0, 2, 512], [0, 0, 4, 4]]",118492
8,"[[0, 8, 64, 2], [0, 4, 128, 8], [0, 0, 2, 512], [0, 0, 4, 4]]",118492,right,8,"[[0, 8, 64, 2], [0, 4, 128, 8], [0, 4, 2, 512], [0, 0, 0, 8]]",118500
8,"[[0, 8, 64, 2], [0, 4, 128, 8], [0, 4, 2, 512], [0, 0, 0, 8]]",118500,up,8,"[[0, 8, 64, 2], [0, 8, 128, 8], [0, 0, 2, 512], [4, 0, 0, 8]]",118508
8,"[[0, 8, 64, 2], [0, 8, 128, 8], [0, 0, 2, 512], [4, 0, 0, 8]]",118508,up,16,"[[4, 16, 64, 2], [0, 0, 128, 8], [0, 0, 2, 512], [0, 2, 0, 8]]",118524
8,"[[4, 16, 64, 2], [0, 0, 128, 8], [0, 0, 2, 512], [0, 2, 0, 8]]",118524,down,0,"[[0, 4, 0, 2], [0, 0, 64, 8], [0, 16, 128, 512], [4, 2, 2, 8]]",118524
8,"[[0, 4, 0, 2], [0, 0, 64, 8], [0, 16, 128, 512], [4, 2, 2, 8]]",118524,right,4,"[[0, 0, 4, 2], [0, 2, 64, 8], [0, 16, 128, 512], [0, 4, 4, 8]]",118528
8,"[[0, 0, 4, 2], [0, 2, 64, 8], [0, 16, 128, 512], [0, 4, 4, 8]]",118528,left,8,"[[4, 2, 2, 0], [2, 64, 8, 0], [16, 128, 512, 0], [8, 8, 0, 0]]",118536
8,"[[4, 2, 2, 0], [2, 64, 8, 0], [16, 128, 512, 0], [8, 8, 0, 0]]",118536,left,20,"[[4, 4, 0, 0], [2, 64, 8, 0], [16, 128, 512, 0], [16, 0, 2, 0]]",118556
8,"[[4, 4, 0, 0], [2, 64, 8, 0], [16, 128, 512, 0], [16, 0, 2, 0]]",118556,down,32,"[[0, 0, 4, 0], [4, 4, 8, 0], [2, 64, 512, 0], [32, 128, 2, 0]]",118588
8,"[[0, 0, 4, 0], [4, 4, 8, 0], [2, 64, 512, 0], [32, 128, 2, 0]]",118588,right,8,"[[0, 0, 2, 4], [0, 0, 8, 8], [0, 2, 64, 512], [0, 32, 128, 2]]",118596
8,"[[0, 0, 2, 4], [0, 0, 8, 8], [0, 2, 64, 512], [0, 32, 128, 2]]",118596,right,16,"[[0, 0, 2, 4], [2, 0, 0, 16], [0, 2, 64, 512], [0, 32, 128, 2]]",118612
8,"[[0, 0, 2, 4], [2, 0, 0, 16], [0, 2, 64, 512], [0, 32, 128, 2]]",118612,up,0,"[[2, 2, 2, 4], [0, 32, 64, 16], [0, 2, 128, 512], [0, 0, 0, 2]]",118612
8,"[[2, 2, 2, 4], [0, 32, 64, 16], [0, 2, 128, 512], [0, 0, 0, 2]]",118612,down,0,"[[0, 0, 4, 4], [0, 2, 2, 16], [0, 32, 64, 512], [2, 2, 128, 2]]",118612
8,"[[0, 0, 4, 4], [0, 2, 2, 16], [0, 32, 64, 512], [2, 2, 128, 2]]",118612,right,16,"[[0, 0, 0, 8], [0, 0, 4, 16], [0, 32, 64, 512], [2, 4, 128, 2]]",118628
8,"[[0, 0, 0, 8], [0, 0, 4, 16], [0, 32, 64, 512], [2, 4, 128, 2]]",118628,down,0,"[[4, 0, 0, 8], [0, 0, 4, 16], [0, 32, 64, 512], [2, 4, 128, 2]]",118628
8,"[[4, 0, 0, 8], [0, 0, 4, 16], [0, 32, 64, 512], [2, 4, 128, 2]]",118628,right,0,"[[0, 0, 4, 8], [2, 0, 4, 16], [0, 32, 64, 512], [2, 4, 128, 2]]",118628
8,"[[0, 0, 4, 8], [2, 0, 4, 16], [0, 32, 64, 512], [2, 4, 128, 2]]",118628,up,12,"[[4, 32, 8, 8], [0, 4, 64, 16], [0, 0, 128, 512], [0, 0, 2, 2]]",118640
8,"[[4, 32, 8, 8], [0, 4, 64, 16], [0, 0, 128, 512], [0, 0, 2, 2]]",118640,right,20,"[[0, 4, 32, 16], [0, 4, 64, 16], [0, 0, 128, 512], [0, 0, 2, 4]]",118660
8,"[[0, 4, 32, 16], [0, 4, 64, 16], [0, 0, 128, 512], [0, 0, 2, 4]]",118660,up,40,"[[0, 8, 32, 32], [0, 0, 64, 512], [0, 0, 128, 4], [0, 0, 2, 2]]",118700
8,"[[0, 8, 32, 32], [0, 0, 64, 512], [0, 0, 128, 4], [0, 0, 2, 2]]",118700,left,68,"[[8, 64, 0, 0], [64, 512, 0, 0], [128, 4, 0, 0], [4, 0, 0, 2]]",118768
8,"[[8, 64, 0, 0], [64, 512, 0, 0], [128, 4, 0, 0], [4, 0, 0, 2]]",118768,down,0,"[[8, 0, 0, 0], [64, 64, 0, 0], [128, 512, 0, 0], [4, 4, 4, 2]]",118768
8,"[[8, 0, 0, 0], [64, 64, 0, 0], [128, 512, 0, 0], [4, 4, 4, 2]]",118768,left,136,"[[8, 0, 0, 0], [128, 0, 4, 0], [128, 512, 0, 0], [8, 4, 2, 0]]",118904
8,"[[8, 0, 0, 0], [128, 0, 4, 0], [128, 512, 0, 0], [8, 4, 2, 0]]",118904,up,256,"[[8, 512, 4, 0], [256, 4, 2, 0], [8, 2, 0, 0], [0, 0, 0, 0]]",119160
8,"[[8, 512, 4, 0], [256, 4, 2, 0], [8, 2, 0, 0], [0, 0, 0, 0]]",119160,down,0,"[[0, 0, 0, 0], [8, 512, 0, 0], [256, 4, 4, 2], [8, 2, 2, 0]]",119160
8,"[[0, 0, 0, 0], [8, 512, 0, 0], [256, 4, 4, 2], [8, 2, 2, 0]]",119160,right,12,"[[0, 0, 2, 0], [0, 0, 8, 512], [0, 256, 8, 2], [0, 0, 8, 4]]",119172
8,"[[0, 0, 2, 0], [0, 0, 8, 512], [0, 256, 8, 2], [0, 0, 8, 4]]",119172,up,16,"[[0, 256, 2, 512], [0, 0, 16, 2], [0, 0, 8, 4], [0, 0, 4, 0]]",119188
8,"[[0, 256, 2, 512], [0, 0, 16, 2], [0, 0, 8, 4], [0, 0, 4, 0]]",119188,left,0,"[[256, 2, 512, 0], [16, 2, 0, 0], [8, 4, 2, 0], [4, 0, 0, 0]]",119188
8,"[[256, 2, 512, 0], [16, 2, 0, 0], [8, 4, 2, 0], [4, 0, 0, 0]]",119188,left,0,"[[256, 2, 512, 0], [16, 2, 0, 0], [8, 4, 2, 2], [4, 0, 0, 0]]",119188
8,"[[256, 2, 512, 0], [16, 2, 0, 0], [8, 4, 2, 2], [4, 0, 0, 0]]",119188,left,4,"[[256, 2, 512, 2], [16, 2, 0, 0], [8, 4, 4, 0], [4, 0, 0, 0]]",119192
8,"[[256, 2, 512, 2], [16, 2, 0, 0], [8, 4, 4, 0], [4, 0, 0, 0]]",119192,left,8,"[[256, 2, 512, 2], [16, 2, 0, 0], [8, 8, 0, 0], [4, 0, 0, 2]]",119200
8,"[[256, 2, 512, 2], [16, 2, 0, 0], [8, 8, 0, 0], [4, 0, 0, 2]]",119200,left,16,"[[256, 2, 512, 2], [16, 2, 4, 0], [16, 0, 0, 0], [4, 2, 0, 0]]",119216
8,"[[256, 2, 512, 2], [16, 2, 4, 0], [16, 0, 0, 0], [4, 2, 0, 0]]",119216,down,36,"[[0, 2, 0, 0], [256, 0, 0, 0], [32, 2, 512, 0], [4, 4, 4, 2]]",119252
8,"[[0, 2, 0, 0], [256, 0, 0, 0], [32, 2, 512, 0], [4, 4, 4, 2]]",119252,up,4,"[[256, 4, 512, 2], [32, 4, 4, 2], [4, 0, 0, 0], [0, 0, 0, 0]]",119256
8,"[[256, 4, 512, 2], [32, 4, 4, 2], [4, 0, 0, 0], [0, 0, 0, 0]]",119256,down,12,"[[0, 0, 2, 0], [256, 0, 0, 0], [32, 0, 512, 0], [4, 8, 4, 4]]",119268
8,"[[0, 0, 2, 0], [256, 0, 0, 0], [32, 0, 512, 0], [4, 8, 4, 4]]",119268,right,8,"[[0, 0, 0, 2], [0, 0, 0, 256], [0, 0, 32, 512], [4, 4, 8, 8]]",119276
8,"[[0, 0, 0, 2], [0, 0, 0, 256], [0, 0, 32, 512], [4, 4, 8, 8]]",119276,right,24,"[[4, 0, 0, 2], [0, 0, 0, 256], [0, 0, 32, 512], [0, 0, 8, 16]]",119300
8,"[[4, 0, 0, 2], [0, 0, 0, 256], [0, 0, 32, 512], [0, 0, 8, 16]]",119300,down,0,"[[0, 0, 0, 2], [4, 0, 0, 256], [0, 0, 32, 512], [4, 0, 8, 16]]",119300
8,"[[0, 0, 0, 2], [4, 0, 0, 256], [0, 0, 32, 512], [4, 0, 8, 16]]",119300,down,8,"[[0, 0, 0, 2], [0, 0, 2, 256], [0, 0, 32, 512], [8, 0, 8, 16]]",119308
8,"[[0, 0, 0, 2], [0, 0, 2, 256], [0, 0, 32, 512], [8, 0, 8, 16]]",119308,left,16,"[[2, 0, 0, 0], [2, 256, 0, 0], [32, 512, 0, 0], [16, 16, 0, 2]]",119324
8,"[[2, 0, 0, 0], [2, 256, 0, 0], [32, 512, 0, 0], [16, 16, 0, 2]]",119324,left,32,"[[2, 2, 0, 0], [2, 256, 0, 0], [32, 512, 0, 0], [32, 2, 0, 0]]",119356
8,"[[2, 2, 0, 0], [2, 256, 0, 0], [32, 512, 0, 0], [32, 2, 0, 0]]",119356,down,68,"[[0, 2, 0, 0], [0, 256, 4, 0], [4, 512, 0, 0], [64, 2, 0, 0]]",119424
8,"[[0, 2, 0, 0], [0, 256, 4, 0], [4, 512, 0, 0], [64, 2, 0, 0]]",119424,right,0,"[[0, 0, 0, 2], [0, 0, 256, 4], [0, 0, 4, 512], [0, 2, 64, 2]]",119424
8,"[[0, 0, 0, 2], [0, 0, 256, 4], [0, 0, 4, 512], [0, 2, 64, 2]]",119424,up,0,"[[0, 2, 256, 2], [0, 0, 4, 4], [0, 0, 64, 512], [0, 0, 2, 2]]",119424
8,"[[0, 2, 256, 2], [0, 0, 4, 4], [0, 0, 64, 512], [0, 0, 2, 2]]",119424,right,12,"[[0, 2, 256, 2], [0, 0, 0, 8], [0, 0, 64, 512], [0, 2, 0, 4]]",119436
8,"[[0, 2, 256, 2], [0, 0, 0, 8], [0, 0, 64, 512], [0, 2, 0, 4]]",119436,up,4,"[[0, 4, 256, 2], [0, 0, 64, 8], [0, 0, 0, 512], [0, 2, 0, 4]]",119440
8,"[[0, 4, 256, 2], [0, 0, 64, 8], [0, 0, 0, 512], [0, 2, 0, 4]]",119440,up,0,"[[0, 4, 256, 2], [0, 2, 64, 8], [0, 0, 0, 512], [4, 0, 0, 4]]",119440
8,"[[0, 4, 256, 2], [0, 2, 64, 8], [0, 0, 0, 512], [4, 0, 0, 4]]",119440,right,8,"[[0, 4, 256, 2], [0, 2, 64, 8], [0, 0, 0, 512], [0, 4, 0, 8]]",119448
8,"[[0, 4, 256, 2], [0, 2, 64, 8], [0, 0, 0, 512], [0, 4, 0, 8]]",119448,down,0,"[[0, 0, 0, 2], [0, 4, 4, 8], [0, 2, 256, 512], [0, 4, 64, 8]]",119448
8,"[[0, 0, 0, 2], [0, 4, 4, 8], [0, 2, 256, 512], [0, 4, 64, 8]]",119448,right,8,"[[0, 0, 0, 2], [0, 0, 8, 8], [0, 2, 256, 512], [2, 4, 64, 8]]",119456
8,"[[0, 0, 0, 2], [0, 0, 8, 8], [0, 2, 256, 512], [2, 4, 64, 8]]",119456,right,16,"[[2, 0, 0, 2], [0, 0, 0, 16], [0, 2, 256, 512], [2, 4, 64, 8]]",119472
8,"[[2, 0, 0, 2], [0, 0, 0, 16], [0, 2, 256, 512], [2, 4, 64, 8]]",119472,right,4,"[[0, 4, 0, 4], [0, 0, 0, 16], [0, 2, 256, 512], [2, 4, 64, 8]]",119476
8,"[[0, 4, 0, 4], [0, 0, 0, 16], [0, 2, 256, 512], [2, 4, 64, 8]]",119476,left,8,"[[8, 0, 0, 0], [16, 0, 0, 2], [2, 256, 512, 0], [2, 4, 64, 8]]",119484
8,"[[8, 0, 0, 0], [16, 0, 0, 2], [2, 256, 512, 0], [2, 4, 64, 8]]",119484,up,4,"[[8, 256, 512, 2], [16, 4, 64, 8], [4, 0, 0, 0], [0, 4, 0, 0]]",119488
8,"[[8, 256, 512, 2], [16, 4, 64, 8], [4, 0, 0, 0], [0, 4, 0, 0]]",119488,up,8,"[[8, 256, 512, 2], [16, 8, 64, 8], [4, 0, 0, 0], [0, 0, 0, 4]]",119496
8,"[[8, 256, 512, 2], [16, 8, 64, 8], [4, 0, 0, 0], [0, 0, 0, 4]]",119496,right,0,"[[8, 256, 512, 2], [16, 8, 64, 8], [0, 0, 0, 4], [0, 4, 0, 4]]",119496
8,"[[8, 256, 512, 2], [16, 8, 64, 8], [0, 0, 0, 4], [0, 4, 0, 4]]",119496,down,8,"[[0, 0, 2, 0], [0, 256, 0, 2], [8, 8, 512, 8], [16, 4, 64, 8]]",119504
8,"[[0, 0, 2, 0], [0, 256, 0, 2], [8, 8, 512, 8], [16, 4, 64, 8]]",119504,left,16,"[[2, 0, 0, 0], [256, 2, 0, 0], [16, 512, 8, 4], [16, 4, 64, 8]]",119520
8,"[[2, 0, 0, 0], [256, 2, 0, 0], [16, 512, 8, 4], [16, 4, 64, 8]]",119520,down,32,"[[0, 0, 0, 0], [2, 2, 0, 2], [256, 512, 8, 4], [32, 4, 64, 8]]",119552
8,"[[0, 0, 0, 0], [2, 2, 0, 2], [256, 512, 8, 4], [32, 4, 64, 8]]",119552,right,4,"[[0, 2, 0, 0], [0, 0, 2, 4], [256, 512, 8, 4], [32, 4, 64, 8]]",119556
8,"[[0, 2, 0, 0], [0, 0, 2, 4], [256, 512, 8, 4], [32, 4, 64, 8]]",119556,up,8,"[[256, 2, 2, 8], [32, 512, 8, 8], [0, 4, 64, 4], [0, 0, 0, 0]]",119564
8,"[[256, 2, 2, 8], [32, 512, 8, 8], [0, 4, 64, 4], [0, 0, 0, 0]]",119564,up,16,"[[256, 2, 2, 16], [32, 512, 8, 4], [0, 4, 64, 0], [0, 4, 0, 0]]",119580
8,"[[256, 2, 2, 16], [32, 512, 8, 4], [0, 4, 64, 0], [0, 4, 0, 0]]",119580,down,8,"[[0, 0, 2, 0], [0, 2, 2, 0], [256, 512, 8, 16], [32, 8, 64, 4]]",119588
8,"[[0, 0, 2, 0], [0, 2, 2, 0], [256, 512, 8, 16], [32, 8, 64, 4]]",119588,left,4,"[[2, 0, 0, 0], [4, 0, 0, 2], [256, 512, 8, 16], [32, 8, 64, 4]]",119592
8,"[[2, 0, 0, 0], [4, 0, 0, 2], [256, 512, 8, 16], [32, 8, 64, 4]]",119592,right,0,"[[2, 0, 0, 2], [0, 0, 4, 2], [256, 512, 8, 16], [32, 8, 64, 4]]",119592
8,"[[2, 0, 0, 2], [0, 0, 4, 2], [256, 512, 8, 16], [32, 8, 64, 4]]",119592,up,4,"[[2, 512, 4, 4], [256, 8, 8, 16], [32, 0, 64, 4], [0, 0, 0, 4]]",119596
8,"[[2, 512, 4, 4], [256, 8, 8, 16], [32, 0, 64, 4], [0, 0, 0, 4]]",119596,left,24,"[[2, 512, 8, 0], [256, 16, 16, 0], [32, 64, 4, 0], [4, 0, 0, 2]]",119620
8,"[[2, 512, 8, 0], [256, 16, 16, 0], [32, 64, 4, 0], [4, 0, 0, 2]]",119620,down,0,"[[2, 0, 0, 0], [256, 512, 8, 2], [32, 16, 16, 0], [4, 64, 4, 2]]",119620
8,"[[2, 0, 0, 0], [256, 512, 8, 2], [32, 16, 16, 0], [4, 64, 4, 2]]",119620,left,32,"[[2, 0, 0, 0], [256, 512, 8, 2], [32, 32, 2, 0], [4, 64, 4, 2]]",119652
8,"[[2, 0, 0, 0], [256, 512, 8, 2], [32, 32, 2, 0], [4, 64, 4, 2]]",119652,left,64,"[[2, 0, 0, 0], [256, 512, 8, 2], [64, 2, 0, 4], [4, 64, 4, 2]]",119716
8,"[[2, 0, 0, 0], [256, 512, 8, 2], [64, 2, 0, 4], [4, 64, 4, 2]]",119716,up,0,"[[2, 512, 8, 2], [256, 2, 4, 4], [64, 64, 2, 2], [4, 0, 0, 0]]",119716
8,"[[2, 512, 8, 2], [256, 2, 4, 4], [64, 64, 2, 2], [4, 0, 0, 0]]",119716,left,140,"[[2, 512, 8, 2], [256, 2, 8, 2], [128, 4, 0, 0], [4, 0, 0, 0]]",119856
8,"[[2, 512, 8, 2], [256, 2, 8, 2], [128, 4, 0, 0], [4, 0, 0, 0]]",119856,up,20,"[[2, 512, 16, 4], [256, 2, 0, 0], [128, 4, 0, 0], [4, 0, 2, 0]]",119876
8,"[[2, 512, 16, 4], [256, 2, 0, 0], [128, 4, 0, 0], [4, 0, 2, 0]]",119876,down,0,"[[2, 0, 0, 0], [256, 512, 0, 0], [128, 2, 16, 4], [4, 4, 2, 4]]",119876
8,"[[2, 0, 0, 0], [256, 512, 0, 0], [128, 2, 16, 4], [4, 4, 2, 4]]",119876,up,8,"[[2, 512, 16, 8], [256, 2, 2, 0], [128, 4, 4, 0], [4, 0, 0, 0]]",119884
8,"[[2, 512, 16, 8], [256, 2, 2, 0], [128, 4, 4, 0], [4, 0, 0, 0]]",119884,left,12,"[[2, 512, 16, 8], [256, 4, 0, 0], [128, 8, 0, 0], [4, 2, 0, 0]]",119896
8,"[[2, 512, 16, 8], [256, 4, 0, 0], [128, 8, 0, 0], [4, 2, 0, 0]]",119896,up,0,"[[2, 512, 16, 8], [256, 4, 0, 0], [128, 8, 2, 0], [4, 2, 0, 0]]",119896
8,"[[2, 512, 16, 8], [256, 4, 0, 0], [128, 8, 2, 0], [4, 2, 0, 0]]",119896,right,0,"[[2, 512, 16, 8], [0, 0, 256, 4], [0, 128, 8, 2], [2, 0, 4, 2]]",119896
8,"[[2, 512, 16, 8], [0, 0, 256, 4], [0, 128, 8, 2], [2, 0, 4, 2]]",119896,up,8,"[[4, 512, 16, 8], [0, 128, 256, 4], [0, 0, 8, 4], [0, 0, 4, 2]]",119904
8,"[[4, 512, 16, 8], [0, 128, 256, 4], [0, 0, 8, 4], [0, 0, 4, 2]]",119904,up,8,"[[4, 512, 16, 8], [0, 128, 256, 8], [0, 4, 8, 2], [0, 0, 4, 0]]",119912
8,"[[4, 512, 16, 8], [0, 128, 256, 8], [0, 4, 8, 2], [0, 0, 4, 0]]",119912,up,16,"[[4, 512, 16, 16], [0, 128, 256, 2], [0, 4, 8, 0], [0, 4, 4, 0]]",119928
8,"[[4, 512, 16, 16], [0, 128, 256, 2], [0, 4, 8, 0], [0, 4, 4, 0]]",119928,right,40,"[[0, 4, 512, 32], [4, 128, 256, 2], [0, 0, 4, 8], [0, 0, 0, 8]]",119968
8,"[[0, 4, 512, 32], [4, 128, 256, 2], [0, 0, 4, 8], [0, 0, 0, 8]]",119968,up,16,"[[4, 4, 512, 32], [0, 128, 256, 2], [4, 0, 4, 16], [0, 0, 0, 0]]",119984
8,"[[4, 4, 512, 32], [0, 128, 256, 2], [4, 0, 4, 16], [0, 0, 0, 0]]",119984,right,16,"[[0, 8, 512, 32], [4, 128, 256, 2], [0, 0, 8, 16], [0, 0, 0, 0]]",120000
8,"[[0, 8, 512, 32], [4, 128, 256, 2], [0, 0, 8, 16], [0, 0, 0, 0]]",120000,up,0,"[[4, 8, 512, 32], [0, 128, 256, 2], [0, 0, 8, 16], [4, 0, 0, 0]]",120000
8,"[[4, 8, 512, 32], [0, 128, 256, 2], [0, 0, 8, 16], [4, 0, 0, 0]]",120000,up,8,"[[8, 8, 512, 32], [0, 128, 256, 2], [0, 0, 8, 16], [0, 0, 0, 4]]",120008
8,"[[8, 8, 512, 32], [0, 128, 256, 2], [0, 0, 8, 16], [0, 0, 0, 4]]",120008,up,0,"[[8, 8, 512, 32], [4, 128, 256, 2], [0, 0, 8, 16], [0, 0, 0, 4]]",120008
8,"[[8, 8, 512, 32], [4, 128, 256, 2], [0, 0, 8, 16], [0, 0, 0, 4]]",120008,left,16,"[[16, 512, 32, 0], [4, 128, 256, 2], [8, 16, 4, 0], [4, 0, 0, 0]]",120024
8,"[[16, 512, 32, 0], [4, 128, 256, 2], [8, 16, 4, 0], [4, 0, 0, 0]]",120024,right,0,"[[0, 16, 512, 32], [4, 128, 256, 2], [0, 8, 16, 4], [0, 4, 0, 4]]",120024
8,"[[0, 16, 512, 32], [4, 128, 256, 2], [0, 8, 16, 4], [0, 4, 0, 4]]",120024,left,8,"[[16, 512, 32, 0], [4, 128, 256, 2], [8, 16, 4, 0], [8, 0, 2, 0]]",120032
8,"[[16, 512, 32, 0], [4, 128, 256, 2], [8, 16, 4, 0], [8, 0, 2, 0]]",120032,down,16,"[[0, 0, 32, 4], [16, 512, 256, 0], [4, 128, 4, 0], [16, 16, 2, 2]]",120048
8,"[[0, 0, 32, 4], [16, 512, 256, 0], [4, 128, 4, 0], [16, 16, 2, 2]]",120048,right,36,"[[0, 2, 32, 4], [0, 16, 512, 256], [0, 4, 128, 4], [0, 0, 32, 4]]",120084
8,"[[0, 2, 32, 4], [0, 16, 512, 256], [0, 4, 128, 4], [0, 0, 32, 4]]",120084,up,8,"[[0, 2, 32, 4], [2, 16, 512, 256], [0, 4, 128, 8], [0, 0, 32, 0]]",120092
8,"[[0, 2, 32, 4], [2, 16, 512, 256], [0, 4, 128, 8], [0, 0, 32, 0]]",120092,left,0,"[[2, 32, 4, 0], [2, 16, 512, 256], [4, 128, 8, 0], [32, 2, 0, 0]]",120092
8,"[[2, 32, 4, 0], [2, 16, 512, 256], [4, 128, 8, 0], [32, 2, 0, 0]]",120092,down,4,"[[2, 32, 0, 0], [4, 16, 4, 0], [4, 128, 512, 0], [32, 2, 8, 256]]",120096
8,"[[2, 32, 0, 0], [4, 16, 4, 0], [4, 128, 512, 0], [32, 2, 8, 256]]",120096,right,0,"[[0, 4, 2, 32], [0, 4, 16, 4], [0, 4, 128, 512], [32, 2, 8, 256]]",120096
8,"[[0, 4, 2, 32], [0, 4, 16, 4], [0, 4, 128, 512], [32, 2, 8, 256]]",120096,down,8,"[[0, 0, 2, 32], [0, 4, 16, 4], [4, 8, 128, 512], [32, 2, 8, 256]]",120104
8,"[[0, 0, 2, 32], [0, 4, 16, 4], [4, 8, 128, 512], [32, 2, 8, 256]]",120104,left,0,"[[2, 32, 0, 0], [4, 16, 4, 4], [4, 8, 128, 512], [32, 2, 8, 256]]",120104
8,"[[2, 32, 0, 0], [4, 16, 4, 4], [4, 8, 128, 512], [32, 2, 8, 256]]",120104,up,8,"[[2, 32, 4, 4], [8, 16, 128, 512], [32, 8, 8, 256], [0, 2, 0, 4]]",120112
8,"[[2, 32, 4, 4], [8, 16, 128, 512], [32, 8, 8, 256], [0, 2, 0, 4]]",120112,left,24,"[[2, 32, 8, 0], [8, 16, 128, 512], [32, 16, 256, 0], [2, 4, 4, 0]]",120136
8,"[[2, 32, 8, 0], [8, 16, 128, 512], [32, 16, 256, 0], [2, 4, 4, 0]]",120136,down,32,"[[2, 4, 8, 0], [8, 32, 128, 0], [32, 32, 256, 0], [2, 4, 4, 512]]",120168
8,"[[2, 4, 8, 0], [8, 32, 128, 0], [32, 32, 256, 0], [2, 4, 4, 512]]",120168,right,72,"[[4, 2, 4, 8], [0, 8, 32, 128], [0, 0, 64, 256], [0, 2, 8, 512]]",120240
8,"[[4, 2, 4, 8], [0, 8, 32, 128], [0, 0, 64, 256], [0, 2, 8, 512]]",120240,down,0,"[[4, 0, 4, 8], [0, 2, 32, 128], [0, 8, 64, 256], [4, 2, 8, 512]]",120240
8,"[[4, 0, 4, 8], [0, 2, 32, 128], [0, 8, 64, 256], [4, 2, 8, 512]]",120240,right,8,"[[0, 2, 8, 8], [0, 2, 32, 128], [0, 8, 64, 256], [4, 2, 8, 512]]",120248
8,"[[0, 2, 8, 8], [0, 2, 32, 128], [0, 8, 64, 256], [4, 2, 8, 512]]",120248,up,4,"[[4, 4, 8, 8], [0, 8, 32, 128], [0, 2, 64, 256], [0, 2, 8, 512]]",120252
8,"[[4, 4, 8, 8], [0, 8, 32, 128], [0, 2, 64, 256], [0, 2, 8, 512]]",120252,left,24,"[[8, 16, 0, 0], [8, 32, 128, 0], [2, 64, 256, 2], [2, 8, 512, 0]]",120276
8,"[[8, 16, 0, 0], [8, 32, 128, 0], [2, 64, 256, 2], [2, 8, 512, 0]]",120276,up,20,"[[16, 16, 128, 2], [4, 32, 256, 0], [0, 64, 512, 0], [0, 8, 0, 2]]",120296
8,"[[16, 16, 128, 2], [4, 32, 256, 0], [0, 64, 512, 0], [0, 8, 0, 2]]",120296,right,32,"[[0, 32, 128, 2], [0, 4, 32, 256], [0, 0, 64, 512], [0, 2, 8, 2]]",120328
8,"[[0, 32, 128, 2], [0, 4, 32, 256], [0, 0, 64, 512], [0, 2, 8, 2]]",120328,down,0,"[[0, 4, 128, 2], [0, 32, 32, 256], [0, 4, 64, 512], [0, 2, 8, 2]]",120328
8,"[[0, 4, 128, 2], [0, 32, 32, 256], [0, 4, 64, 512], [0, 2, 8, 2]]",120328,right,64,"[[2, 4, 128, 2], [0, 0, 64, 256], [0, 4, 64, 512], [0, 2, 8, 2]]",120392
8,"[[2, 4, 128, 2], [0, 0, 64, 256], [0, 4, 64, 512], [0, 2, 8, 2]]",120392,up,136,"[[2, 8, 128, 2], [0, 2, 128, 256], [0, 0, 8, 512], [0, 4, 0, 2]]",120528
8,"[[2, 8, 128, 2], [0, 2, 128, 256], [0, 0, 8, 512], [0, 4, 0, 2]]",120528,up,256,"[[2, 8, 256, 2], [0, 2, 8, 256], [0, 4, 0, 512], [0, 0, 2, 2]]",120784
8,"[[2, 8, 256, 2], [0, 2, 8, 256], [0, 4, 0, 512], [0, 0, 2, 2]]",120784,down,0,"[[0, 0, 0, 2], [0, 8, 256, 256], [4, 2, 8, 512], [2, 4, 2, 2]]",120784
8,"[[0, 0, 0, 2], [0, 8, 256, 256], [4, 2, 8, 512], [2, 4, 2, 2]]",120784,right,516,"[[0, 2, 0, 2], [0, 0, 8, 512], [4, 2, 8, 512], [0, 2, 4, 4]]",121300
8,"[[0, 2, 0, 2], [0, 0, 8, 512], [4, 2, 8, 512], [0, 2, 4, 4]]",121300,down,1044,"[[2, 0, 0, 0], [0, 0, 0, 2], [0, 2, 16, 1024], [4, 4, 4, 4]]",122344
8,"[[2, 0, 0, 0], [0, 0, 0, 2], [0, 2, 16, 1024], [4, 4, 4, 4]]",122344,right,16,"[[0, 0, 0, 2], [0, 0, 0, 2], [2, 2, 16, 1024], [0, 0, 8, 8]]",122360
8,"[[0, 0, 0, 2], [0, 0, 0, 2], [2, 2, 16, 1024], [0, 0, 8, 8]]",122360,left,20,"[[2, 0, 0, 0], [2, 0, 0, 0], [4, 16, 1024, 0], [16, 0, 0, 2]]",122380
8,"[[2, 0, 0, 0], [2, 0, 0, 0], [4, 16, 1024, 0], [16, 0, 0, 2]]",122380,down,4,"[[4, 0, 0, 0], [4, 0, 0, 0], [4, 0, 0, 0], [16, 16, 1024, 2]]",122384
8,"[[4, 0, 0, 0], [4, 0, 0, 0], [4, 0, 0, 0], [16, 16, 1024, 2]]",122384,left,32,"[[4, 0, 0, 0], [4, 0, 0, 0], [4, 0, 0, 4], [32, 1024, 2, 0]]",122416
8,"[[4, 0, 0, 0], [4, 0, 0, 0], [4, 0, 0, 4], [32, 1024, 2, 0]]",122416,left,8,"[[4, 4, 0, 0], [4, 0, 0, 0], [8, 0, 0, 0], [32, 1024, 2, 0]]",122424
8,"[[4, 4, 0, 0], [4, 0, 0, 0], [8, 0, 0, 0], [32, 1024, 2, 0]]",122424,down,8,"[[0, 0, 0, 0], [8, 0, 0, 0], [8, 4, 0, 0], [32, 1024, 2, 2]]",122432
8,"[[0, 0, 0, 0], [8, 0, 0, 0], [8, 4, 0, 0], [32, 1024, 2, 2]]",122432,down,16,"[[0, 0, 0, 0], [0, 0, 0, 0], [16, 4, 0, 2], [32, 1024, 2, 2]]",122448
8,"[[0, 0, 0, 0], [0, 0, 0, 0], [16, 4, 0, 2], [32, 1024, 2, 2]]",122448,down,4,"[[0, 0, 0, 0], [0, 0, 2, 0], [16, 4, 0, 0], [32, 1024, 2, 4]]",122452
8,"[[0, 0, 0, 0], [0, 0, 2, 0], [16, 4, 0, 0], [32, 1024, 2, 4]]",122452,down,4,"[[0, 0, 0, 0], [0, 4, 0, 0], [16, 4, 0, 0], [32, 1024, 4, 4]]",122456
8,"[[0, 0, 0, 0], [0, 4, 0, 0], [16, 4, 0, 0], [32, 1024, 4, 4]]",122456,up,8,"[[16, 8, 4, 4], [32, 1024, 0, 0], [0, 0, 0, 0], [0, 0, 2, 0]]",122464
8,"[[16, 8, 4, 4], [32, 1024, 0, 0], [0, 0, 0, 0], [0, 0, 2, 0]]",122464,left,8,"[[16, 8, 8, 0], [32, 1024, 0, 4], [0, 0, 0, 0], [2, 0, 0, 0]]",122472
8,"[[16, 8, 8, 0], [32, 1024, 0, 4], [0, 0, 0, 0], [2, 0, 0, 0]]",122472,left,16,"[[16, 16, 0, 0], [32, 1024, 4, 4], [0, 0, 0, 0], [2, 0, 0, 0]]",122488
8,"[[16, 16, 0, 0], [32, 1024, 4, 4], [0, 0, 0, 0], [2, 0, 0, 0]]",122488,left,40,"[[32, 0, 0, 0], [32, 1024, 8, 0], [0, 0, 0, 0], [2, 0, 0, 2]]",122528
8,"[[32, 0, 0, 0], [32, 1024, 8, 0], [0, 0, 0, 0], [2, 0, 0, 2]]",122528,up,64,"[[64, 1024, 8, 2], [2, 0, 0, 0], [0, 0, 0, 4], [0, 0, 0, 0]]",122592
8,"[[64, 1024, 8, 2], [2, 0, 0, 0], [0, 0, 0, 4], [0, 0, 0, 0]]",122592,right,0,"[[64, 1024, 8, 2], [0, 0, 0, 2], [2, 0, 0, 4], [0, 0, 0, 0]]",122592
8,"[[64, 1024, 8, 2], [0, 0, 0, 2], [2, 0, 0, 4], [0, 0, 0, 0]]",122592,up,4,"[[64, 1024, 8, 4], [2, 0, 0, 4], [0, 0, 0, 0], [0, 0, 2, 0]]",122596
8,"[[64, 1024, 8, 4], [2, 0, 0, 4], [0, 0, 0, 0], [0, 0, 2, 0]]",122596,up,8,"[[64, 1024, 8, 8], [2, 0, 2, 0], [0, 0, 0, 0], [0, 0, 0, 2]]",122604
8,"[[64, 1024, 8, 8], [2, 0, 2, 0], [0, 0, 0, 0], [0, 0, 0, 2]]",122604,right,20,"[[0, 64, 1024, 16], [0, 0, 0, 4], [0, 0, 0, 0], [0, 2, 0, 2]]",122624
8,"[[0, 64, 1024, 16], [0, 0, 0, 4], [0, 0, 0, 0], [0, 2, 0, 2]]",122624,left,4,"[[64, 1024, 16, 0], [4, 0, 0, 0], [0, 0, 0, 0], [4, 2, 0, 0]]",122628
8,"[[64, 1024, 16, 0], [4, 0, 0, 0], [0, 0, 0, 0], [4, 2, 0, 0]]",122628,up,8,"[[64, 1024, 16, 2], [8, 2, 0, 0], [0, 0, 0, 0], [0, 0, 0, 0]]",122636
8,"[[64, 1024, 16, 2], [8, 2, 0, 0], [0, 0, 0, 0], [0, 0, 0, 0]]",122636,right,0,"[[64, 1024, 16, 2], [0, 0, 8, 2], [0, 0, 0, 2], [0, 0, 0, 0]]",122636
8,"[[64, 1024, 16, 2], [0, 0, 8, 2], [0, 0, 0, 2], [0, 0, 0, 0]]",122636,down,4,"[[0, 0, 0, 2], [0, 0, 0, 0], [0, 0, 16, 2], [64, 1024, 8, 4]]",122640
8,"[[0, 0, 0, 2], [0, 0, 0, 0], [0, 0, 16, 2], [64, 1024, 8, 4]]",122640,down,4,"[[0, 0, 0, 0], [0, 2, 0, 0], [0, 0, 16, 4], [64, 1024, 8, 4]]",122644
8,"[[0, 0, 0, 0], [0, 2, 0, 0], [0, 0, 16, 4], [64, 1024, 8, 4]]",122644,down,8,"[[0, 4, 0, 0], [0, 0, 0, 0], [0, 2, 16, 0], [64, 1024, 8, 8]]",122652
8,"[[0, 4, 0, 0], [0, 0, 0, 0], [0, 2, 16, 0], [64, 1024, 8, 8]]",122652,right,16,"[[0, 0, 0, 4], [0, 0, 0, 0], [0, 2, 2, 16], [0, 64, 1024, 16]]",122668
8,"[[0, 0, 0, 4], [0, 0, 0, 0], [0, 2, 2, 16], [0, 64, 1024, 16]]",122668,down,32,"[[0, 0, 0, 0], [0, 0, 4, 0], [0, 2, 2, 4], [0, 64, 1024, 32]]",122700
8,"[[0, 0, 0, 0], [0, 0, 4, 0], [0, 2, 2, 4], [0, 64, 1024, 32]]",122700,right,4,"[[0, 0, 0, 0], [0, 0, 0, 4], [0, 4, 4, 4], [0, 64, 1024, 32]]",122704
8,"[[0, 0, 0, 0], [0, 0, 0, 4], [0, 4, 4, 4], [0, 64, 1024, 32]]",122704,down,8,"[[4, 0, 0, 0], [0, 0, 0, 0], [0, 4, 4, 8], [0, 64, 1024, 32]]",122712
8,"[[4, 0, 0, 0], [0, 0, 0, 0], [0, 4, 4, 8], [0, 64, 1024, 32]]",122712,left,8,"[[4, 0, 0, 0], [0, 0, 0, 0], [8, 8, 0, 2], [64, 1024, 32, 0]]",122720
8,"[[4, 0, 0, 0], [0, 0, 0, 0], [8, 8, 0, 2], [64, 1024, 32, 0]]",122720,left,16,"[[4, 0, 0, 0], [0, 0, 0, 0], [16, 2, 0, 4], [64, 1024, 32, 0]]",122736
8,"[[4, 0, 0, 0], [0, 0, 0, 0], [16, 2, 0, 4], [64, 1024, 32, 0]]",122736,right,0,"[[0, 0, 0, 4], [0, 2, 0, 0], [0, 16, 2, 4], [0, 64, 1024, 32]]",122736
8,"[[0, 0, 0, 4], [0, 2, 0, 0], [0, 16, 2, 4], [0, 64, 1024, 32]]",122736,up,8,"[[0, 2, 2, 8], [0, 16, 1024, 32], [0, 64, 0, 0], [4, 0, 0, 0]]",122744
8,"[[0, 2, 2, 8], [0, 16, 1024, 32], [0, 64, 0, 0], [4, 0, 0, 0]]",122744,right,4,"[[0, 0, 4, 8], [0, 16, 1024, 32], [0, 2, 0, 64], [0, 0, 0, 4]]",122748
8,"[[0, 0, 4, 8], [0, 16, 1024, 32], [0, 2, 0, 64], [0, 0, 0, 4]]",122748,up,0,"[[0, 16, 4, 8], [2, 2, 1024, 32], [0, 0, 0, 64], [0, 0, 0, 4]]",122748
8,"[[0, 16, 4, 8], [2, 2, 1024, 32], [0, 0, 0, 64], [0, 0, 0, 4]]",122748,right,4,"[[0, 16, 4, 8], [0, 4, 1024, 32], [0, 0, 2, 64], [0, 0, 0, 4]]",122752
8,"[[0, 16, 4, 8], [0, 4, 1024, 32], [0, 0, 2, 64], [0, 0, 0, 4]]",122752,up,0,"[[0, 16, 4, 8], [0, 4, 1024, 32], [4, 0, 2, 64], [0, 0, 0, 4]]",122752
8,"[[0, 16, 4, 8], [0, 4, 1024, 32], [4, 0, 2, 64], [0, 0, 0, 4]]",122752,left,0,"[[16, 4, 8, 0], [4, 1024, 32, 0], [4, 2, 64, 0], [4, 0, 0, 2]]",122752
8,"[[16, 4, 8, 0], [4, 1024, 32, 0], [4, 2, 64, 0], [4, 0, 0, 2]]",122752,up,8,"[[16, 4, 8, 2], [8, 1024, 32, 0], [4, 2, 64, 0], [0, 0, 4, 0]]",122760
8,"[[16, 4, 8, 2], [8, 1024, 32, 0], [4, 2, 64, 0], [0, 0, 4, 0]]",122760,left,0,"[[16, 4, 8, 2], [8, 1024, 32, 2], [4, 2, 64, 0], [4, 0, 0, 0]]",122760
8,"[[16, 4, 8, 2], [8, 1024, 32, 2], [4, 2, 64, 0], [4, 0, 0, 0]]",122760,down,12,"[[0, 2, 0, 0], [16, 4, 8, 0], [8, 1024, 32, 0], [8, 2, 64, 4]]",122772
8,"[[0, 2, 0, 0], [16, 4, 8, 0], [8, 1024, 32, 0], [8, 2, 64, 4]]",122772,down,16,"[[0, 2, 0, 0], [0, 4, 8, 4], [16, 1024, 32, 0], [16, 2, 64, 4]]",122788
8,"[[0, 2, 0, 0], [0, 4, 8, 4], [16, 1024, 32, 0], [16, 2, 64, 4]]",122788,up,40,"[[32, 2, 8, 8], [0, 4, 32, 0], [0, 1024, 64, 0], [4, 2, 0, 0]]",122828
8,"[[32, 2, 8, 8], [0, 4, 32, 0], [0, 1024, 64, 0], [4, 2, 0, 0]]",122828,left,16,"[[32, 2, 16, 0], [4, 32, 0, 0], [1024, 64, 0, 0], [4, 2, 0, 4]]",122844
8,"[[32, 2, 16, 0], [4, 32, 0, 0], [1024, 64, 0, 0], [4, 2, 0, 4]]",122844,down,0,"[[32, 2, 0, 2], [4, 32, 0, 0], [1024, 64, 0, 0], [4, 2, 16, 4]]",122844
8,"[[32, 2, 0, 2], [4, 32, 0, 0], [1024, 64, 0, 0], [4, 2, 16, 4]]",122844,down,0,"[[32, 2, 0, 0], [4, 32, 4, 0], [1024, 64, 0, 2], [4, 2, 16, 4]]",122844
8,"[[32, 2, 0, 0], [4, 32, 4, 0], [1024, 64, 0, 2], [4, 2, 16, 4]]",122844,right,0,"[[4, 0, 32, 2], [0, 4, 32, 4], [0, 1024, 64, 2], [4, 2, 16, 4]]",122844
8,"[[4, 0, 32, 2], [0, 4, 32, 4], [0, 1024, 64, 2], [4, 2, 16, 4]]",122844,down,72,"[[0, 0, 0, 2], [2, 4, 64, 4], [0, 1024, 64, 2], [8, 2, 16, 4]]",122916
8,"[[0, 0, 0, 2], [2, 4, 64, 4], [0, 1024, 64, 2], [8, 2, 16, 4]]",122916,up,128,"[[2, 4, 128, 2], [8, 1024, 16, 4], [0, 2, 2, 2], [0, 0, 0, 4]]",123044
8,"[[2, 4, 128, 2], [8, 1024, 16, 4], [0, 2, 2, 2], [0, 0, 0, 4]]",123044,left,4,"[[2, 4, 128, 2], [8, 1024, 16, 4], [4, 2, 2, 0], [4, 0, 0, 0]]",123048
8,"[[2, 4, 128, 2], [8, 1024, 16, 4], [4, 2, 2, 0], [4, 0, 0, 0]]",123048,down,8,"[[0, 0, 0, 0], [2, 4, 128, 2], [8, 1024, 16, 2], [8, 2, 2, 4]]",123056
8,"[[0, 0, 0, 0], [2, 4, 128, 2], [8, 1024, 16, 2], [8, 2, 2, 4]]",123056,down,20,"[[0, 0, 0, 0], [0, 4, 128, 2], [2, 1024, 16, 4], [16, 2, 2, 4]]",123076
8,"[[0, 0, 0, 0], [0, 4, 128, 2], [2, 1024, 16, 4], [16, 2, 2, 4]]",123076,right,4,"[[0, 0, 4, 0], [0, 4, 128, 2], [2, 1024, 16, 4], [0, 16, 4, 4]]",123080
8,"[[0, 0, 4, 0], [0, 4, 128, 2], [2, 1024, 16, 4], [0, 16, 4, 4]]",123080,up,8,"[[2, 4, 4, 2], [0, 1024, 128, 8], [4, 16, 16, 0], [0, 0, 4, 0]]",123088
8,"[[2, 4, 4, 2], [0, 1024, 128, 8], [4, 16, 16, 0], [0, 0, 4, 0]]",123088,right,40,"[[0, 2, 8, 2], [0, 1024, 128, 8], [2, 0, 4, 32], [0, 0, 0, 4]]",123128
8,"[[0, 2, 8, 2], [0, 1024, 128, 8], [2, 0, 4, 32], [0, 0, 0, 4]]",123128,down,0,"[[0, 4, 0, 2], [0, 0, 8, 8], [0, 2, 128, 32], [2, 1024, 4, 4]]",123128
8,"[[0, 4, 0, 2], [0, 0, 8, 8], [0, 2, 128, 32], [2, 1024, 4, 4]]",123128,right,24,"[[2, 0, 4, 2], [0, 0, 0, 16], [0, 2, 128, 32], [0, 2, 1024, 8]]",123152
8,"[[2, 0, 4, 2], [0, 0, 0, 16], [0, 2, 128, 32], [0, 2, 1024, 8]]",123152,down,4,"[[0, 4, 0, 2], [0, 0, 4, 16], [0, 0, 128, 32], [2, 4, 1024, 8]]",123156
8,"[[0, 4, 0, 2], [0, 0, 4, 16], [0, 0, 128, 32], [2, 4, 1024, 8]]",123156,right,0,"[[4, 0, 4, 2], [0, 0, 4, 16], [0, 0, 128, 32], [2, 4, 1024, 8]]",123156
8,"[[4, 0, 4, 2], [0, 0, 4, 16], [0, 0, 128, 32], [2, 4, 1024, 8]]",123156,up,8,"[[4, 4, 8, 2], [2, 0, 128, 16], [0, 0, 1024, 32], [2, 0, 0, 8]]",123164
8,"[[4, 4, 8, 2], [2, 0, 128, 16], [0, 0, 1024, 32], [2, 0, 0, 8]]",123164,left,8,"[[8, 8, 2, 0], [2, 128, 16, 4], [1024, 32, 0, 0], [2, 8, 0, 0]]",123172
8,"[[8, 8, 2, 0], [2, 128, 16, 4], [1024, 32, 0, 0], [2, 8, 0, 0]]",123172,right,16,"[[2, 0, 16, 2], [2, 128, 16, 4], [0, 0, 1024, 32], [0, 0, 2, 8]]",123188
8,"[[2, 0, 16, 2], [2, 128, 16, 4], [0, 0, 1024, 32], [0, 0, 2, 8]]",123188,down,36,"[[0, 4, 0, 2], [0, 0, 32, 4], [0, 0, 1024, 32], [4, 128, 2, 8]]",123224
8,"[[0, 4, 0, 2], [0, 0, 32, 4], [0, 0, 1024, 32], [4, 128, 2, 8]]",123224,left,0,"[[4, 2, 0, 0], [32, 4, 0, 4], [1024, 32, 0, 0], [4, 128, 2, 8]]",123224
8,"[[4, 2, 0, 0], [32, 4, 0, 4], [1024, 32, 0, 0], [4, 128, 2, 8]]",123224,down,0,"[[4, 2, 0, 0], [32, 4, 0, 4], [1024, 32, 0, 4], [4, 128, 2, 8]]",123224
8,"[[4, 2, 0, 0], [32, 4, 0, 4], [1024, 32, 0, 4], [4, 128, 2, 8]]",123224,right,8,"[[0, 0, 4, 2], [0, 0, 32, 8], [4, 1024, 32, 4], [4, 128, 2, 8]]",123232
8,"[[0, 0, 4, 2], [0, 0, 32, 8], [4, 1024, 32, 4], [4, 128, 2, 8]]",123232,down,72,"[[0, 0, 2, 2], [0, 0, 4, 8], [0, 1024, 64, 4], [8, 128, 2, 8]]",123304
8,"[[0, 0, 2, 2], [0, 0, 4, 8], [0, 1024, 64, 4], [8, 128, 2, 8]]",123304,left,4,"[[4, 0, 0, 0], [4, 8, 0, 4], [1024, 64, 4, 0], [8, 128, 2, 8]]",123308
8,"[[4, 0, 0, 0], [4, 8, 0, 4], [1024, 64, 4, 0], [8, 128, 2, 8]]",123308,up,8,"[[8, 8, 4, 4], [1024, 64, 2, 8], [8, 128, 4, 0], [0, 0, 0, 0]]",123316
8,"[[8, 8, 4, 4], [1024, 64, 2, 8], [8, 128, 4, 0], [0, 0, 0, 0]]",123316,right,24,"[[4, 0, 16, 8], [1024, 64, 2, 8], [0, 8, 128, 4], [0, 0, 0, 0]]",123340
8,"[[4, 0, 16, 8], [1024, 64, 2, 8], [0, 8, 128, 4], [0, 0, 0, 0]]",123340,up,16,"[[4, 64, 16, 16], [1024, 8, 2, 4], [0, 0, 128, 0], [0, 0, 0, 4]]",123356
8,"[[4, 64, 16, 16], [1024, 8, 2, 4], [0, 0, 128, 0], [0, 0, 0, 4]]",123356,left,32,"[[4, 64, 32, 0], [1024, 8, 2, 4], [128, 0, 4, 0], [4, 0, 0, 0]]",123388
8,"[[4, 64, 32, 0], [1024, 8, 2, 4], [128, 0, 4, 0], [4, 0, 0, 0]]",123388,down,0,"[[4, 0, 0, 0], [1024, 2, 32, 0], [128, 64, 2, 0], [4, 8, 4, 4]]",123388
8,"[[4, 0, 0, 0], [1024, 2, 32, 0], [128, 64, 2, 0], [4, 8, 4, 4]]",123388,left,8,"[[4, 0, 4, 0], [1024, 2, 32, 0], [128, 64, 2, 0], [4, 8, 8, 0]]",123396
8,"[[4, 0, 4, 0], [1024, 2, 32, 0], [128, 64, 2, 0], [4, 8, 8, 0]]",123396,left,24,"[[8, 0, 0, 0], [1024, 2, 32, 0], [128, 64, 2, 0], [4, 16, 4, 0]]",123420
8,"[[8, 0, 0, 0], [1024, 2, 32, 0], [128, 64, 2, 0], [4, 16, 4, 0]]",123420,down,0,"[[8, 0, 0, 0], [1024, 2, 32, 2], [128, 64, 2, 0], [4, 16, 4, 0]]",123420
8,"[[8, 0, 0, 0], [1024, 2, 32, 2], [128, 64, 2, 0], [4, 16, 4, 0]]",123420,right,0,"[[0, 0, 0, 8], [1024, 2, 32, 2], [0, 128, 64, 2], [4, 4, 16, 4]]",123420
8,"[[0, 0, 0, 8], [1024, 2, 32, 2], [0, 128, 64, 2], [4, 4, 16, 4]]",123420,up,4,"[[1024, 2, 32, 8], [4, 128, 64, 4], [0, 4, 16, 4], [0, 0, 0, 4]]",123424
8,"[[1024, 2, 32, 8], [4, 128, 64, 4], [0, 4, 16, 4], [0, 0, 0, 4]]",123424,up,8,"[[1024, 2, 32, 8], [4, 128, 64, 8], [0, 4, 16, 4], [0, 0, 2, 0]]",123432
8,"[[1024, 2, 32, 8], [4, 128, 64, 8], [0, 4, 16, 4], [0, 0, 2, 0]]",123432,down,16,"[[0, 2, 32, 0], [0, 2, 64, 0], [1024, 128, 16, 16], [4, 4, 2, 4]]",123448
8,"[[0, 2, 32, 0], [0, 2, 64, 0], [1024, 128, 16, 16], [4, 4, 2, 4]]",123448,left,40,"[[2, 32, 2, 0], [2, 64, 0, 0], [1024, 128, 32, 0], [8, 2, 4, 0]]",123488
8,"[[2, 32, 2, 0], [2, 64, 0, 0], [1024, 128, 32, 0], [8, 2, 4, 0]]",123488,up,4,"[[4, 32, 2, 0], [1024, 64, 32, 0], [8, 128, 4, 2], [0, 2, 0, 0]]",123492
8,"[[4, 32, 2, 0], [1024, 64, 32, 0], [8, 128, 4, 2], [0, 2, 0, 0]]",123492,up,0,"[[4, 32, 2, 2], [1024, 64, 32, 2], [8, 128, 4, 0], [0, 2, 0, 0]]",123492
8,"[[4, 32, 2, 2], [1024, 64, 32, 2], [8, 128, 4, 0], [0, 2, 0, 0]]",123492,right,4,"[[0, 4, 32, 4], [1024, 64, 32, 2], [0, 8, 128, 4], [0, 4, 0, 2]]",123496
8,"[[0, 4, 32, 4], [1024, 64, 32, 2], [0, 8, 128, 4], [0, 4, 0, 2]]",123496,up,64,"[[1024, 4, 64, 4], [0, 64, 128, 2], [0, 8, 0, 4], [2, 4, 0, 2]]",123560
8,"[[1024, 4, 64, 4], [0, 64, 128, 2], [0, 8, 0, 4], [2, 4, 0, 2]]",123560,down,0,"[[0, 4, 0, 4], [0, 64, 2, 2], [1024, 8, 64, 4], [2, 4, 128, 2]]",123560
8,"[[0, 4, 0, 4], [0, 64, 2, 2], [1024, 8, 64, 4], [2, 4, 128, 2]]",123560,right,12,"[[2, 0, 0, 8], [0, 0, 64, 4], [1024, 8, 64, 4], [2, 4, 128, 2]]",123572
8,"[[2, 0, 0, 8], [0, 0, 64, 4], [1024, 8, 64, 4], [2, 4, 128, 2]]",123572,up,136,"[[2, 8, 128, 8], [1024, 4, 128, 8], [2, 0, 2, 2], [0, 0, 0, 0]]",123708
8,"[[2, 8, 128, 8], [1024, 4, 128, 8], [2, 0, 2, 2], [0, 0, 0, 0]]",123708,up,272,"[[2, 8, 256, 16], [1024, 4, 2, 2], [2, 0, 4, 0], [0, 0, 0, 0]]",123980
8,"[[2, 8, 256, 16], [1024, 4, 2, 2], [2, 0, 4, 0], [0, 0, 0, 0]]",123980,left,4,"[[2, 8, 256, 16], [1024, 4, 4, 0], [2, 4, 4, 0], [0, 0, 0, 0]]",123984
8,"[[2, 8, 256, 16], [1024, 4, 4, 0], [2, 4, 4, 0], [0, 0, 0, 0]]",123984,down,16,"[[0, 0, 0, 0], [2, 0, 0, 2], [1024, 8, 256, 0], [2, 8, 8, 16]]",124000
8,"[[0, 0, 0, 0], [2, 0, 0, 2], [1024, 8, 256, 0], [2, 8, 8, 16]]",124000,left,20,"[[0, 2, 0, 0], [4, 0, 0, 0], [1024, 8, 256, 0], [2, 16, 16, 0]]",124020
8,"[[0, 2, 0, 0], [4, 0, 0, 0], [1024, 8, 256, 0], [2, 16, 16, 0]]",124020,right,32,"[[0, 0, 0, 2], [0, 0, 0, 4], [0, 1024, 8, 256], [2, 0, 2, 32]]",124052
8,"[[0, 0, 0, 2], [0, 0, 0, 4], [0, 1024, 8, 256], [2, 0, 2, 32]]",124052,right,4,"[[0, 0, 0, 2], [0, 0, 0, 4], [4, 1024, 8, 256], [0, 0, 4, 32]]",124056
8,"[[0, 0, 0, 2], [0, 0, 0, 4], [4, 1024, 8, 256], [0, 0, 4, 32]]",124056,up,0,"[[4, 1024, 8, 2], [2, 0, 4, 4], [0, 0, 0, 256], [0, 0, 0, 32]]",124056
8,"[[4, 1024, 8, 2], [2, 0, 4, 4], [0, 0, 0, 256], [0, 0, 0, 32]]",124056,left,8,"[[4, 1024, 8, 2], [2, 8, 0, 4], [256, 0, 0, 0], [32, 0, 0, 0]]",124064
8,"[[4, 1024, 8, 2], [2, 8, 0, 4], [256, 0, 0, 0], [32, 0, 0, 0]]",124064,down,0,"[[4, 2, 0, 0], [2, 0, 0, 0], [256, 1024, 0, 2], [32, 8, 8, 4]]",124064
8,"[[4, 2, 0, 0], [2, 0, 0, 0], [256, 1024, 0, 2], [32, 8, 8, 4]]",124064,right,16,"[[4, 0, 4, 2], [0, 0, 0, 2], [0, 256, 1024, 2], [0, 32, 16, 4]]",124080
8,"[[4, 0, 4, 2], [0, 0, 0, 2], [0, 256, 1024, 2], [0, 32, 16, 4]]",124080,left,8,"[[8, 2, 4, 0], [2, 0, 0, 0], [256, 1024, 2, 0], [32, 16, 4, 0]]",124088
8,"[[8, 2, 4, 0], [2, 0, 0, 0], [256, 1024, 2, 0], [32, 16, 4, 0]]",124088,right,0,"[[0, 8, 2, 4], [0, 2, 0, 2], [0, 256, 1024, 2], [0, 32, 16, 4]]",124088
8,"[[0, 8, 2, 4], [0, 2, 0, 2], [0, 256, 1024, 2], [0, 32, 16, 4]]",124088,down,4,"[[0, 8, 0, 2], [0, 2, 2, 4], [0, 256, 1024, 4], [0, 32, 16, 4]]",124092
8,"[[0, 8, 0, 2], [0, 2, 2, 4], [0, 256, 1024, 4], [0, 32, 16, 4]]",124092,left,4,"[[8, 2, 4, 0], [4, 4, 0, 0], [256, 1024, 4, 0], [32, 16, 4, 0]]",124096
8,"[[8, 2, 4, 0], [4, 4, 0, 0], [256, 1024, 4, 0], [32, 16, 4, 0]]",124096,left,8,"[[8, 2, 4, 0], [8, 0, 0, 0], [256, 1024, 4, 2], [32, 16, 4, 0]]",124104
8,"[[8, 2, 4, 0], [8, 0, 0, 0], [256, 1024, 4, 2], [32, 16, 4, 0]]",124104,down,24,"[[0, 2, 0, 0], [16, 2, 0, 0], [256, 1024, 4, 0], [32, 16, 8, 2]]",124128
8,"[[0, 2, 0, 0], [16, 2, 0, 0], [256, 1024, 4, 0], [32, 16, 8, 2]]",124128,down,4,"[[0, 0, 0, 0], [16, 4, 0, 0], [256, 1024, 4, 4], [32, 16, 8, 2]]",124132
8,"[[0, 0, 0, 0], [16, 4, 0, 0], [256, 1024, 4, 4], [32, 16, 8, 2]]",124132,left,8,"[[0, 0, 0, 0], [16, 4, 0, 2], [256, 1024, 8, 0], [32, 16, 8, 2]]",124140
8,"[[0, 0, 0, 0], [16, 4, 0, 2], [256, 1024, 8, 0], [32, 16, 8, 2]]",124140,down,20,"[[0, 0, 2, 0], [16, 4, 0, 0], [256, 1024, 0, 0], [32, 16, 16, 4]]",124160
8,"[[0, 0, 2, 0], [16, 4, 0, 0], [256, 1024, 0, 0], [32, 16, 16, 4]]",124160,left,32,"[[2, 0, 0, 0], [16, 4, 0, 0], [256, 1024, 0, 2], [32, 32, 4, 0]]",124192
8,"[[2, 0, 0, 0], [16, 4, 0, 0], [256, 1024, 0, 2], [32, 32, 4, 0]]",124192,left,64,"[[2, 0, 0, 0], [16, 4, 4, 0], [256, 1024, 2, 0], [64, 4, 0, 0]]",124256
8,"[[2, 0, 0, 0], [16, 4, 4, 0], [256, 1024, 2, 0], [64, 4, 0, 0]]",124256,left,8,"[[2, 0, 2, 0], [16, 8, 0, 0], [256, 1024, 2, 0], [64, 4, 0, 0]]",124264
8,"[[2, 0, 2, 0], [16, 8, 0, 0], [256, 1024, 2, 0], [64, 4, 0, 0]]",124264,left,4,"[[4, 2, 0, 0], [16, 8, 0, 0], [256, 1024, 2, 0], [64, 4, 0, 0]]",124268
8,"[[4, 2, 0, 0], [16, 8, 0, 0], [256, 1024, 2, 0], [64, 4, 0, 0]]",124268,up,0,"[[4, 2, 2, 0], [16, 8, 0, 0], [256, 1024, 2, 0], [64, 4, 0, 0]]",124268
8,"[[4, 2, 2, 0], [16, 8, 0, 0], [256, 1024, 2, 0], [64, 4, 0, 0]]",124268,left,4,"[[4, 4, 2, 0], [16, 8, 0, 0], [256, 1024, 2, 0], [64, 4, 0, 0]]",124272
8,"[[4, 4, 2, 0], [16, 8, 0, 0], [256, 1024, 2, 0], [64, 4, 0, 0]]",124272,down,4,"[[4, 4, 0, 0], [16, 8, 2, 0], [256, 1024, 0, 0], [64, 4, 4, 0]]",124276
8,"[[4, 4, 0, 0], [16, 8, 2, 0], [256, 1024, 0, 0], [64, 4, 4, 0]]",124276,left,16,"[[8, 0, 0, 0], [16, 8, 2, 0], [256, 1024, 0, 4], [64, 8, 0, 0]]",124292
8,"[[8, 0, 0, 0], [16, 8, 2, 0], [256, 1024, 0, 4], [64, 8, 0, 0]]",124292,up,0,"[[8, 8, 2, 4], [16, 1024, 2, 0], [256, 8, 0, 0], [64, 0, 0, 0]]",124292
8,"[[8, 8, 2, 4], [16, 1024, 2, 0], [256, 8, 0, 0], [64, 0, 0, 0]]",124292,right,16,"[[0, 16, 2, 4], [0, 16, 1024, 2], [0, 0, 256, 8], [0, 0, 2, 64]]",124308
8,"[[0, 16, 2, 4], [0, 16, 1024, 2], [0, 0, 256, 8], [0, 0, 2, 64]]",124308,up,32,"[[0, 32, 2, 4], [0, 0, 1024, 2], [0, 2, 256, 8], [0, 0, 2, 64]]",124340
8,"[[0, 32, 2, 4], [0, 0, 1024, 2], [0, 2, 256, 8], [0, 0, 2, 64]]",124340,left,0,"[[32, 2, 4, 0], [1024, 2, 0, 4], [2, 256, 8, 0], [2, 64, 0, 0]]",124340
8,"[[32, 2, 4, 0], [1024, 2, 0, 4], [2, 256, 8, 0], [2, 64, 0, 0]]",124340,down,8,"[[0, 0, 0, 4], [32, 4, 0, 0], [1024, 256, 4, 0], [4, 64, 8, 4]]",124348
8,"[[0, 0, 0, 4], [32, 4, 0, 0], [1024, 256, 4, 0], [4, 64, 8, 4]]",124348,down,8,"[[2, 0, 0, 0], [32, 4, 0, 0], [1024, 256, 4, 0], [4, 64, 8, 8]]",124356
8,"[[2, 0, 0, 0], [32, 4, 0, 0], [1024, 256, 4, 0], [4, 64, 8, 8]]",124356,left,16,"[[2, 0, 0, 0], [32, 4, 0, 4], [1024, 256, 4, 0], [4, 64, 16, 0]]",124372
8,"[[2, 0, 0, 0], [32, 4, 0, 4], [1024, 256, 4, 0], [4, 64, 16, 0]]",124372,left,8,"[[2, 2, 0, 0], [32, 8, 0, 0], [1024, 256, 4, 0], [4, 64, 16, 0]]",124380
8,"[[2, 2, 0, 0], [32, 8, 0, 0], [1024, 256, 4, 0], [4, 64, 16, 0]]",124380,left,4,"[[4, 0, 0, 0], [32, 8, 0, 0], [1024, 256, 4, 0], [4, 64, 16, 2]]",124384
8,"[[4, 0, 0, 0], [32, 8, 0, 0], [1024, 256, 4, 0], [4, 64, 16, 2]]",124384,down,0,"[[4, 0, 0, 0], [32, 8, 2, 0], [1024, 256, 4, 0], [4, 64, 16, 2]]",124384
8,"[[4, 0, 0, 0], [32, 8, 2, 0], [1024, 256, 4, 0], [4, 64, 16, 2]]",124384,up,0,"[[4, 8, 2, 2], [32, 256, 4, 0], [1024, 64, 16, 0], [4, 0, 2, 0]]",124384
8,"[[4, 8, 2, 2], [32, 256, 4, 0], [1024, 64, 16, 0], [4, 0, 2, 0]]",124384,right,4,"[[0, 4, 8, 4], [0, 32, 256, 4], [2, 1024, 64, 16], [0, 0, 4, 2]]",124388
8,"[[0, 4, 8, 4], [0, 32, 256, 4], [2, 1024, 64, 16], [0, 0, 4, 2]]",124388,up,8,"[[2, 4, 8, 8], [4, 32, 256, 16], [0, 1024, 64, 2], [0, 0, 4, 0]]",124396
8,"[[2, 4, 8, 8], [4, 32, 256, 16], [0, 1024, 64, 2], [0, 0, 4, 0]]",124396,right,16,"[[0, 2, 4, 16], [4, 32, 256, 16], [0, 1024, 64, 2], [0, 0, 2, 4]]",124412
8,"[[0, 2, 4, 16], [4, 32, 256, 16], [0, 1024, 64, 2], [0, 0, 2, 4]]",124412,down,32,"[[0, 0, 4, 2], [0, 2, 256, 32], [0, 32, 64, 2], [4, 1024, 2, 4]]",124444
8,"[[0, 0, 4, 2], [0, 2, 256, 32], [0, 32, 64, 2], [4, 1024, 2, 4]]",124444,left,0,"[[4, 2, 0, 2], [2, 256, 32, 0], [32, 64, 2, 0], [4, 1024, 2, 4]]",124444
8,"[[4, 2, 0, 2], [2, 256, 32, 0], [32, 64, 2, 0], [4, 1024, 2, 4]]",124444,left,4,"[[4, 4, 4, 0], [2, 256, 32, 0], [32, 64, 2, 0], [4, 1024, 2, 4]]",124448
8,"[[4, 4, 4, 0], [2, 256, 32, 0], [32, 64, 2, 0], [4, 1024, 2, 4]]",124448,up,4,"[[4, 4, 4, 4], [2, 256, 32, 0], [32, 64, 4, 2], [4, 1024, 0, 0]]",124452
8,"[[4, 4, 4, 4], [2, 256, 32, 0], [32, 64, 4, 2], [4, 1024, 0, 0]]",124452,right,16,"[[2, 0, 8, 8], [0, 2, 256, 32], [32, 64, 4, 2], [0, 0, 4, 1024]]",124468
8,"[[2, 0, 8, 8], [0, 2, 256, 32], [32, 64, 4, 2], [0, 0, 4, 1024]]",124468,right,16,"[[0, 0, 2, 16], [0, 2, 256, 32], [32, 64, 4, 2], [2, 0, 4, 1024]]",124484
8,"[[0, 0, 2, 16], [0, 2, 256, 32], [32, 64, 4, 2], [2, 0, 4, 1024]]",124484,up,8,"[[32, 2, 2, 16], [2, 64, 256, 32], [0, 0, 8, 2], [0, 2, 0, 1024]]",124492
8,"[[32, 2, 2, 16], [2, 64, 256, 32], [0, 0, 8, 2], [0, 2, 0, 1024]]",124492,right,4,"[[4, 32, 4, 16], [2, 64, 256, 32], [0, 0, 8, 2], [0, 0, 2, 1024]]",124496
8,"[[4, 32, 4, 16], [2, 64, 256, 32], [0, 0, 8, 2], [0, 0, 2, 1024]]",124496,down,0,"[[4, 0, 4, 16], [0, 0, 256, 32], [4, 32, 8, 2], [2, 64, 2, 1024]]",124496
8,"[[4, 0, 4, 16], [0, 0, 256, 32], [4, 32, 8, 2], [2, 64, 2, 1024]]",124496,left,8,"[[8, 16, 2, 0], [256, 32, 0, 0], [4, 32, 8, 2], [2, 64, 2, 1024]]",124504
8,"[[8, 16, 2, 0], [256, 32, 0, 0], [4, 32, 8, 2], [2, 64, 2, 1024]]",124504,down,64,"[[8, 0, 0, 2], [256, 16, 2, 0], [4, 64, 8, 2], [2, 64, 2, 1024]]",124568
8,"[[8, 0, 0, 2], [256, 16, 2, 0], [4, 64, 8, 2], [2, 64, 2, 1024]]",124568,down,132,"[[8, 0, 0, 2], [256, 0, 2, 0], [4, 16, 8, 4], [2, 128, 2, 1024]]",124700
8,"[[8, 0, 0, 2], [256, 0, 2, 0], [4, 16, 8, 4], [2, 128, 2, 1024]]",124700,up,0,"[[8, 16, 2, 2], [256, 128, 8, 4], [4, 2, 2, 1024], [2, 0, 0, 0]]",124700
8,"[[8, 16, 2, 2], [256, 128, 8, 4], [4, 2, 2, 1024], [2, 0, 0, 0]]",124700,right,8,"[[0, 8, 16, 4], [256, 128, 8, 4], [0, 4, 4, 1024], [0, 4, 0, 2]]",124708
8,"[[0, 8, 16, 4], [256, 128, 8, 4], [0, 4, 4, 1024], [0, 4, 0, 2]]",124708,right,8,"[[0, 8, 16, 4], [256, 128, 8, 4], [2, 0, 8, 1024], [0, 0, 4, 2]]",124716
8,"[[0, 8, 16, 4], [256, 128, 8, 4], [2, 0, 8, 1024], [0, 0, 4, 2]]",124716,up,24,"[[256, 8, 16, 8], [2, 128, 16, 1024], [0, 0, 4, 2], [0, 0, 0, 2]]",124740
8,"[[256, 8, 16, 8], [2, 128, 16, 1024], [0, 0, 4, 2], [0, 0, 0, 2]]",124740,down,36,"[[0, 2, 0, 0], [0, 0, 0, 8], [256, 8, 32, 1024], [2, 128, 4, 4]]",124776
8,"[[0, 2, 0, 0], [0, 0, 0, 8], [256, 8, 32, 1024], [2, 128, 4, 4]]",124776,left,8,"[[2, 0, 2, 0], [8, 0, 0, 0], [256, 8, 32, 1024], [2, 128, 8, 0]]",124784
8,"[[2, 0, 2, 0], [8, 0, 0, 0], [256, 8, 32, 1024], [2, 128, 8, 0]]",124784,left,4,"[[4, 2, 0, 0], [8, 0, 0, 0], [256, 8, 32, 1024], [2, 128, 8, 0]]",124788
8,"[[4, 2, 0, 0], [8, 0, 0, 0], [256, 8, 32, 1024], [2, 128, 8, 0]]",124788,up,0,"[[4, 2, 32, 1024], [8, 8, 8, 0], [256, 128, 0, 4], [2, 0, 0, 0]]",124788
8,"[[4, 2, 32, 1024], [8, 8, 8, 0], [256, 128, 0, 4], [2, 0, 0, 0]]",124788,left,16,"[[4, 2, 32, 1024], [16, 8, 2, 0], [256, 128, 4, 0], [2, 0, 0, 0]]",124804
8,"[[4, 2, 32, 1024], [16, 8, 2, 0], [256, 128, 4, 0], [2, 0, 0, 0]]",124804,up,0,"[[4, 2, 32, 1024], [16, 8, 2, 4], [256, 128, 4, 0], [2, 0, 0, 0]]",124804
8,"[[4, 2, 32, 1024], [16, 8, 2, 4], [256, 128, 4, 0], [2, 0, 0, 0]]",124804,down,0,"[[4, 4, 0, 0], [16, 2, 32, 0], [256, 8, 2, 1024], [2, 128, 4, 4]]",124804
8,"[[4, 4, 0, 0], [16, 2, 32, 0], [256, 8, 2, 1024], [2, 128, 4, 4]]",124804,up,0,"[[4, 4, 32, 1024], [16, 2, 2, 4], [256, 8, 4, 0], [2, 128, 4, 0]]",124804
8,"[[4, 4, 32, 1024], [16, 2, 2, 4], [256, 8, 4, 0], [2, 128, 4, 0]]",124804,up,8,"[[4, 4, 32, 1024], [16, 2, 2, 4], [256, 8, 8, 0], [2, 128, 0, 4]]",124812
8,"[[4, 4, 32, 1024], [16, 2, 2, 4], [256, 8, 8, 0], [2, 128, 0, 4]]",124812,left,28,"[[8, 32, 1024, 0], [16, 4, 4, 0], [256, 16, 0, 4], [2, 128, 4, 0]]",124840
8,"[[8, 32, 1024, 0], [16, 4, 4, 0], [256, 16, 0, 4], [2, 128, 4, 0]]",124840,right,8,"[[0, 8, 32, 1024], [0, 2, 16, 8], [0, 256, 16, 4], [0, 2, 128, 4]]",124848
8,"[[0, 8, 32, 1024], [0, 2, 16, 8], [0, 256, 16, 4], [0, 2, 128, 4]]",124848,down,40,"[[0, 8, 0, 2], [0, 2, 32, 1024], [0, 256, 32, 8], [0, 2, 128, 8]]",124888
8,"[[0, 8, 0, 2], [0, 2, 32, 1024], [0, 256, 32, 8], [0, 2, 128, 8]]",124888,down,80,"[[0, 8, 0, 0], [0, 2, 0, 2], [0, 256, 64, 1024], [4, 2, 128, 16]]",124968
8,"[[0, 8, 0, 0], [0, 2, 0, 2], [0, 256, 64, 1024], [4, 2, 128, 16]]",124968,right,4,"[[0, 0, 0, 8], [0, 0, 0, 4], [2, 256, 64, 1024], [4, 2, 128, 16]]",124972
8,"[[0, 0, 0, 8], [0, 0, 0, 4], [2, 256, 64, 1024], [4, 2, 128, 16]]",124972,down,0,"[[0, 0, 0, 8], [0, 0, 2, 4], [2, 256, 64, 1024], [4, 2, 128, 16]]",124972
8,"[[0, 0, 0, 8], [0, 0, 2, 4], [2, 256, 64, 1024], [4, 2, 128, 16]]",124972,left,0,"[[8, 0, 2, 0], [2, 4, 0, 0], [2, 256, 64, 1024], [4, 2, 128, 16]]",124972
8,"[[8, 0, 2, 0], [2, 4, 0, 0], [2, 256, 64, 1024], [4, 2, 128, 16]]",124972,down,4,"[[0, 0, 2, 0], [8, 4, 2, 0], [4, 256, 64, 1024], [4, 2, 128, 16]]",124976
8,"[[0, 0, 2, 0], [8, 4, 2, 0], [4, 256, 64, 1024], [4, 2, 128, 16]]",124976,up,12,"[[8, 4, 4, 1024], [8, 256, 64, 16], [0, 2, 128, 0], [0, 0, 0, 2]]",124988
8,"[[8, 4, 4, 1024], [8, 256, 64, 16], [0, 2, 128, 0], [0, 0, 0, 2]]",124988,left,8,"[[8, 8, 1024, 4], [8, 256, 64, 16], [2, 128, 0, 0], [2, 0, 0, 0]]",124996
8,"[[8, 8, 1024, 4], [8, 256, 64, 16], [2, 128, 0, 0], [2, 0, 0, 0]]",124996,up,20,"[[16, 8, 1024, 4], [4, 256, 64, 16], [4, 128, 0, 0], [0, 0, 0, 0]]",125016
8,"[[16, 8, 1024, 4], [4, 256, 64, 16], [4, 128, 0, 0], [0, 0, 0, 0]]",125016,down,8,"[[0, 0, 0, 0], [2, 8, 0, 0], [16, 256, 1024, 4], [8, 128, 64, 16]]",125024
8,"[[0, 0, 0, 0], [2, 8, 0, 0], [16, 256, 1024, 4], [8, 128, 64, 16]]",125024,down,0,"[[0, 0, 0, 2], [2, 8, 0, 0], [16, 256, 1024, 4], [8, 128, 64, 16]]",125024
8,"[[0, 0, 0, 2], [2, 8, 0, 0], [16, 256, 1024, 4], [8, 128, 64, 16]]",125024,left,0,"[[2, 0, 0, 0], [2, 8, 2, 0], [16, 256, 1024, 4], [8, 128, 64, 16]]",125024
8,"[[2, 0, 0, 0], [2, 8, 2, 0], [16, 256, 1024, 4], [8, 128, 64, 16]]",125024,down,4,"[[0, 2, 0, 0], [4, 8, 2, 0], [16, 256, 1024, 4], [8, 128, 64, 16]]",125028
8,"[[0, 2, 0, 0], [4, 8, 2, 0], [16, 256, 1024, 4], [8, 128, 64, 16]]",125028,right,0,"[[0, 0, 2, 2], [0, 4, 8, 2], [16, 256, 1024, 4], [8, 128, 64, 16]]",125028
8,"[[0, 0, 2, 2], [0, 4, 8, 2], [16, 256, 1024, 4], [8, 128, 64, 16]]",125028,left,4,"[[4, 2, 0, 0], [4, 8, 2, 0], [16, 256, 1024, 4], [8, 128, 64, 16]]",125032
8,"[[4, 2, 0, 0], [4, 8, 2, 0], [16, 256, 1024, 4], [8, 128, 64, 16]]",125032,down,8,"[[0, 2, 0, 0], [8, 8, 2, 4], [16, 256, 1024, 4], [8, 128, 64, 16]]",125040
8,"[[0, 2, 0, 0], [8, 8, 2, 4], [16, 256, 1024, 4], [8, 128, 64, 16]]",125040,left,16,"[[2, 4, 0, 0], [16, 2, 4, 0], [16, 256, 1024, 4], [8, 128, 64, 16]]",125056
8,"[[2, 4, 0, 0], [16, 2, 4, 0], [16, 256, 1024, 4], [8, 128, 64, 16]]",125056,down,32,"[[0, 4, 2, 0], [2, 2, 4, 0], [32, 256, 1024, 4], [8, 128, 64, 16]]",125088
8,"[[0, 4, 2, 0], [2, 2, 4, 0], [32, 256, 1024, 4], [8, 128, 64, 16]]",125088,right,4,"[[0, 0, 4, 2], [0, 2, 4, 4], [32, 256, 1024, 4], [8, 128, 64, 16]]",125092
8,"[[0, 0, 4, 2], [0, 2, 4, 4], [32, 256, 1024, 4], [8, 128, 64, 16]]",125092,down,16,"[[0, 4, 0, 0], [0, 2, 8, 2], [32, 256, 1024, 8], [8, 128, 64, 16]]",125108
8,"[[0, 4, 0, 0], [0, 2, 8, 2], [32, 256, 1024, 8], [8, 128, 64, 16]]",125108,down,0,"[[2, 4, 0, 0], [0, 2, 8, 2], [32, 256, 1024, 8], [8, 128, 64, 16]]",125108
8,"[[2, 4, 0, 0], [0, 2, 8, 2], [32, 256, 1024, 8], [8, 128, 64, 16]]",125108,left,0,"[[2, 4, 0, 4], [2, 8, 2, 0], [32, 256, 1024, 8], [8, 128, 64, 16]]",125108
8,"[[2, 4, 0, 4], [2, 8, 2, 0], [32, 256, 1024, 8], [8, 128, 64, 16]]",125108,left,8,"[[2, 8, 4, 0], [2, 8, 2, 0], [32, 256, 1024, 8], [8, 128, 64, 16]]",125116
8,"[[2, 8, 4, 0], [2, 8, 2, 0], [32, 256, 1024, 8], [8, 128, 64, 16]]",125116,down,20,"[[0, 4, 4, 0], [4, 16, 2, 0], [32, 256, 1024, 8], [8, 128, 64, 16]]",125136
8,"[[0, 4, 4, 0], [4, 16, 2, 0], [32, 256, 1024, 8], [8, 128, 64, 16]]",125136,down,0,"[[0, 4, 4, 0], [4, 16, 2, 4], [32, 256, 1024, 8], [8, 128, 64, 16]]",125136
8,"[[0, 4, 4, 0], [4, 16, 2, 4], [32, 256, 1024, 8], [8, 128, 64, 16]]",125136,up,0,"[[4, 4, 4, 4], [32, 16, 2, 8], [8, 256, 1024, 16], [0, 128, 64, 2]]",125136
8,"[[4, 4, 4, 4], [32, 16, 2, 8], [8, 256, 1024, 16], [0, 128, 64, 2]]",125136,right,16,"[[0, 0, 8, 8], [32, 16, 2, 8], [8, 256, 1024, 16], [4, 128, 64, 2]]",125152
8,"[[0, 0, 8, 8], [32, 16, 2, 8], [8, 256, 1024, 16], [4, 128, 64, 2]]",125152,up,16,"[[32, 16, 8, 16], [8, 256, 2, 16], [4, 128, 1024, 2], [0, 4, 64, 0]]",125168
8,"[[32, 16, 8, 16], [8, 256, 2, 16], [4, 128, 1024, 2], [0, 4, 64, 0]]",125168,down,32,"[[0, 16, 8, 0], [32, 256, 2, 2], [8, 128, 1024, 32], [4, 4, 64, 2]]",125200
8,"[[0, 16, 8, 0], [32, 256, 2, 2], [8, 128, 1024, 32], [4, 4, 64, 2]]",125200,left,12,"[[16, 8, 2, 0], [32, 256, 4, 0], [8, 128, 1024, 32], [8, 64, 2, 0]]",125212
8,"[[16, 8, 2, 0], [32, 256, 4, 0], [8, 128, 1024, 32], [8, 64, 2, 0]]",125212,up,16,"[[16, 8, 2, 32], [32, 256, 4, 4], [16, 128, 1024, 0], [0, 64, 2, 0]]",125228
8,"[[16, 8, 2, 32], [32, 256, 4, 4], [16, 128, 1024, 0], [0, 64, 2, 0]]",125228,left,8,"[[16, 8, 2, 32], [32, 256, 8, 0], [16, 128, 1024, 0], [64, 2, 4, 0]]",125236
8,"[[16, 8, 2, 32], [32, 256, 8, 0], [16, 128, 1024, 0], [64, 2, 4, 0]]",125236,right,0,"[[16, 8, 2, 32], [4, 32, 256, 8], [0, 16, 128, 1024], [0, 64, 2, 4]]",125236
8,"[[16, 8, 2, 32], [4, 32, 256, 8], [0, 16, 128, 1024], [0, 64, 2, 4]]",125236,down,0,"[[0, 8, 2, 32], [2, 32, 256, 8], [16, 16, 128, 1024], [4, 64, 2, 4]]",125236
8,"[[0, 8, 2, 32], [2, 32, 256, 8], [16, 16, 128, 1024], [4, 64, 2, 4]]",125236,right,32,"[[2, 8, 2, 32], [2, 32, 256, 8], [0, 32, 128, 1024], [4, 64, 2, 4]]",125268
8,"[[2, 8, 2, 32], [2, 32, 256, 8], [0, 32, 128, 1024], [4, 64, 2, 4]]",125268,right,0,"[[2, 8, 2, 32], [2, 32, 256, 8], [2, 32, 128, 1024], [4, 64, 2, 4]]",125268
8,"[[2, 8, 2, 32], [2, 32, 256, 8], [2, 32, 128, 1024], [4, 64, 2, 4]]",125268,down,68,"[[4, 0, 2, 32], [2, 8, 256, 8], [4, 64, 128, 1024], [4, 64, 2, 4]]",125336
8,"[[4, 0, 2, 32], [2, 8, 256, 8], [4, 64, 128, 1024], [4, 64, 2, 4]]",125336,up,136,"[[4, 8, 2, 32], [2, 128, 256, 8], [8, 4, 128, 1024], [0, 0, 2, 4]]",125472
8,"[[4, 8, 2, 32], [2, 128, 256, 8], [8, 4, 128, 1024], [0, 0, 2, 4]]",125472,up,0,"[[4, 8, 2, 32], [2, 128, 256, 8], [8, 4, 128, 1024], [0, 4, 2, 4]]",125472
8,"[[4, 8, 2, 32], [2, 128, 256, 8], [8, 4, 128, 1024], [0, 4, 2, 4]]",125472,down,8,"[[4, 0, 2, 32], [4, 8, 256, 8], [2, 128, 128, 1024], [8, 8, 2, 4]]",125480
8,"[[4, 0, 2, 32], [4, 8, 256, 8], [2, 128, 128, 1024], [8, 8, 2, 4]]",125480,right,272,"[[2, 4, 2, 32], [4, 8, 256, 8], [0, 2, 256, 1024], [0, 16, 2, 4]]",125752
8,"[[2, 4, 2, 32], [4, 8, 256, 8], [0, 2, 256, 1024], [0, 16, 2, 4]]",125752,down,512,"[[4, 4, 0, 32], [0, 8, 2, 8], [2, 2, 512, 1024], [4, 16, 2, 4]]",126264
8,"[[4, 4, 0, 32], [0, 8, 2, 8], [2, 2, 512, 1024], [4, 16, 2, 4]]",126264,left,12,"[[8, 32, 0, 2], [8, 2, 8, 0], [4, 512, 1024, 0], [4, 16, 2, 4]]",126276
8,"[[8, 32, 0, 2], [8, 2, 8, 0], [4, 512, 1024, 0], [4, 16, 2, 4]]",126276,down,24,"[[0, 32, 4, 0], [0, 2, 8, 0], [16, 512, 1024, 2], [8, 16, 2, 4]]",126300
8,"[[0, 32, 4, 0], [0, 2, 8, 0], [16, 512, 1024, 2], [8, 16, 2, 4]]",126300,left,0,"[[32, 4, 0, 0], [2, 8, 2, 0], [16, 512, 1024, 2], [8, 16, 2, 4]]",126300
8,"[[32, 4, 0, 0], [2, 8, 2, 0], [16, 512, 1024, 2], [8, 16, 2, 4]]",126300,up,0,"[[32, 4, 2, 2], [2, 8, 1024, 4], [16, 512, 2, 0], [8, 16, 0, 2]]",126300
8,"[[32, 4, 2, 2], [2, 8, 1024, 4], [16, 512, 2, 0], [8, 16, 0, 2]]",126300,left,4,"[[32, 4, 4, 0], [2, 8, 1024, 4], [16, 512, 2, 4], [8, 16, 2, 0]]",126304
8,"[[32, 4, 4, 0], [2, 8, 1024, 4], [16, 512, 2, 4], [8, 16, 2, 0]]",126304,up,12,"[[32, 4, 4, 8], [2, 8, 1024, 0], [16, 512, 4, 2], [8, 16, 0, 0]]",126316
8,"[[32, 4, 4, 8], [2, 8, 1024, 0], [16, 512, 4, 2], [8, 16, 0, 0]]",126316,left,8,"[[32, 8, 8, 0], [2, 8, 1024, 0], [16, 512, 4, 2], [8, 16, 0, 2]]",126324
8,"[[32, 8, 8, 0], [2, 8, 1024, 0], [16, 512, 4, 2], [8, 16, 0, 2]]",126324,up,20,"[[32, 16, 8, 4], [2, 512, 1024, 0], [16, 16, 4, 0], [8, 0, 0, 4]]",126344
8,"[[32, 16, 8, 4], [2, 512, 1024, 0], [16, 16, 4, 0], [8, 0, 0, 4]]",126344,up,8,"[[32, 16, 8, 8], [2, 512, 1024, 0], [16, 16, 4, 2], [8, 0, 0, 0]]",126352
8,"[[32, 16, 8, 8], [2, 512, 1024, 0], [16, 16, 4, 2], [8, 0, 0, 0]]",126352,left,48,"[[32, 16, 16, 0], [2, 512, 1024, 2], [32, 4, 2, 0], [8, 0, 0, 0]]",126400
8,"[[32, 16, 16, 0], [2, 512, 1024, 2], [32, 4, 2, 0], [8, 0, 0, 0]]",126400,left,32,"[[32, 32, 0, 0], [2, 512, 1024, 2], [32, 4, 2, 4], [8, 0, 0, 0]]",126432
8,"[[32, 32, 0, 0], [2, 512, 1024, 2], [32, 4, 2, 4], [8, 0, 0, 0]]",126432,right,64,"[[0, 2, 0, 64], [2, 512, 1024, 2], [32, 4, 2, 4], [0, 0, 0, 8]]",126496
8,"[[0, 2, 0, 64], [2, 512, 1024, 2], [32, 4, 2, 4], [0, 0, 0, 8]]",126496,up,0,"[[2, 2, 1024, 64], [32, 512, 2, 2], [0, 4, 4, 4], [0, 0, 0, 8]]",126496
8,"[[2, 2, 1024, 64], [32, 512, 2, 2], [0, 4, 4, 4], [0, 0, 0, 8]]",126496,right,16,"[[0, 4, 1024, 64], [0, 32, 512, 4], [4, 0, 4, 8], [0, 0, 0, 8]]",126512
8,"[[0, 4, 1024, 64], [0, 32, 512, 4], [4, 0, 4, 8], [0, 0, 0, 8]]",126512,left,8,"[[4, 1024, 64, 0], [32, 512, 4, 2], [8, 8, 0, 0], [8, 0, 0, 0]]",126520
8,"[[4, 1024, 64, 0], [32, 512, 4, 2], [8, 8, 0, 0], [8, 0, 0, 0]]",126520,right,16,"[[0, 4, 1024, 64], [32, 512, 4, 2], [2, 0, 0, 16], [0, 0, 0, 8]]",126536
8,"[[0, 4, 1024, 64], [32, 512, 4, 2], [2, 0, 0, 16], [0, 0, 0, 8]]",126536,up,0,"[[32, 4, 1024, 64], [2, 512, 4, 2], [0, 0, 0, 16], [2, 0, 0, 8]]",126536
8,"[[32, 4, 1024, 64], [2, 512, 4, 2], [0, 0, 0, 16], [2, 0, 0, 8]]",126536,up,4,"[[32, 4, 1024, 64], [4, 512, 4, 2], [2, 0, 0, 16], [0, 0, 0, 8]]",126540
8,"[[32, 4, 1024, 64], [4, 512, 4, 2], [2, 0, 0, 16], [0, 0, 0, 8]]",126540,right,0,"[[32, 4, 1024, 64], [4, 512, 4, 2], [4, 0, 2, 16], [0, 0, 0, 8]]",126540
8,"[[32, 4, 1024, 64], [4, 512, 4, 2], [4, 0, 2, 16], [0, 0, 0, 8]]",126540,down,8,"[[0, 0, 2, 64], [0, 0, 1024, 2], [32, 4, 4, 16], [8, 512, 2, 8]]",126548
8,"[[0, 0, 2, 64], [0, 0, 1024, 2], [32, 4, 4, 16], [8, 512, 2, 8]]",126548,right,8,"[[0, 0, 2, 64], [0, 4, 1024, 2], [0, 32, 8, 16], [8, 512, 2, 8]]",126556
8,"[[0, 0, 2, 64], [0, 4, 1024, 2], [0, 32, 8, 16], [8, 512, 2, 8]]",126556,right,0,"[[2, 0, 2, 64], [0, 4, 1024, 2], [0, 32, 8, 16], [8, 512, 2, 8]]",126556
8,"[[2, 0, 2, 64], [0, 4, 1024, 2], [0, 32, 8, 16], [8, 512, 2, 8]]",126556,left,4,"[[4, 64, 0, 0], [4, 1024, 2, 2], [32, 8, 16, 0], [8, 512, 2, 8]]",126560
8,"[[4, 64, 0, 0], [4, 1024, 2, 2], [32, 8, 16, 0], [8, 512, 2, 8]]",126560,up,8,"[[8, 64, 2, 2], [32, 1024, 16, 8], [8, 8, 2, 0], [4, 512, 0, 0]]",126568
8,"[[8, 64, 2, 2], [32, 1024, 16, 8], [8, 8, 2, 0], [4, 512, 0, 0]]",126568,right,20,"[[0, 8, 64, 4], [32, 1024, 16, 8], [0, 4, 16, 2], [0, 0, 4, 512]]",126588
8,"[[0, 8, 64, 4], [32, 1024, 16, 8], [0, 4, 16, 2], [0, 0, 4, 512]]",126588,down,32,"[[0, 0, 4, 4], [0, 8, 64, 8], [0, 1024, 32, 2], [32, 4, 4, 512]]",126620
8,"[[0, 0, 4, 4], [0, 8, 64, 8], [0, 1024, 32, 2], [32, 4, 4, 512]]",126620,left,16,"[[8, 0, 0, 0], [8, 64, 8, 0], [1024, 32, 2, 0], [32, 8, 512, 4]]",126636
8,"[[8, 0, 0, 0], [8, 64, 8, 0], [1024, 32, 2, 0], [32, 8, 512, 4]]",126636,up,16,"[[16, 64, 8, 4], [1024, 32, 2, 0], [32, 8, 512, 0], [0, 0, 4, 0]]",126652
8,"[[16, 64, 8, 4], [1024, 32, 2, 0], [32, 8, 512, 0], [0, 0, 4, 0]]",126652,down,0,"[[0, 0, 8, 0], [16, 64, 2, 0], [1024, 32, 512, 4], [32, 8, 4, 4]]",126652
8,"[[0, 0, 8, 0], [16, 64, 2, 0], [1024, 32, 512, 4], [32, 8, 4, 4]]",126652,right,8,"[[0, 0, 0, 8], [0, 16, 64, 2], [1024, 32, 512, 4], [2, 32, 8, 8]]",126660
8,"[[0, 0, 0, 8], [0, 16, 64, 2], [1024, 32, 512, 4], [2, 32, 8, 8]]",126660,left,16,"[[8, 0, 0, 4], [16, 64, 2, 0], [1024, 32, 512, 4], [2, 32, 16, 0]]",126676
8,"[[8, 0, 0, 4], [16, 64, 2, 0], [1024, 32, 512, 4], [2, 32, 16, 0]]",126676,up,72,"[[8, 64, 2, 8], [16, 64, 512, 0], [1024, 0, 16, 0], [2, 4, 0, 0]]",126748
8,"[[8, 64, 2, 8], [16, 64, 512, 0], [1024, 0, 16, 0], [2, 4, 0, 0]]",126748,down,128,"[[8, 0, 2, 0], [16, 0, 2, 0], [1024, 128, 512, 0], [2, 4, 16, 8]]",126876
8,"[[8, 0, 2, 0], [16, 0, 2, 0], [1024, 128, 512, 0], [2, 4, 16, 8]]",126876,down,4,"[[8, 0, 2, 0], [16, 0, 4, 0], [1024, 128, 512, 0], [2, 4, 16, 8]]",126880
8,"[[8, 0, 2, 0], [16, 0, 4, 0], [1024, 128, 512, 0], [2, 4, 16, 8]]",126880,up,0,"[[8, 128, 2, 8], [16, 4, 4, 0], [1024, 0, 512, 0], [2, 0, 16, 4]]",126880
8,"[[8, 128, 2, 8], [16, 4, 4, 0], [1024, 0, 512, 0], [2, 0, 16, 4]]",126880,right,8,"[[8, 128, 2, 8], [2, 0, 16, 8], [0, 0, 1024, 512], [0, 2, 16, 4]]",126888
8,"[[8, 128, 2, 8], [2, 0, 16, 8], [0, 0, 1024, 512], [0, 2, 16, 4]]",126888,down,16,"[[0, 2, 2, 0], [0, 0, 16, 16], [8, 128, 1024, 512], [2, 2, 16, 4]]",126904
8,"[[0, 2, 2, 0], [0, 0, 16, 16], [8, 128, 1024, 512], [2, 2, 16, 4]]",126904,left,40,"[[4, 0, 0, 0], [32, 0, 4, 0], [8, 128, 1024, 512], [4, 16, 4, 0]]",126944
8,"[[4, 0, 0, 0], [32, 0, 4, 0], [8, 128, 1024, 512], [4, 16, 4, 0]]",126944,up,0,"[[4, 128, 4, 512], [32, 16, 1024, 0], [8, 0, 4, 0], [4, 0, 0, 4]]",126944
8,"[[4, 128, 4, 512], [32, 16, 1024, 0], [8, 0, 4, 0], [4, 0, 0, 4]]",126944,left,8,"[[4, 128, 4, 512], [32, 16, 1024, 0], [8, 4, 0, 0], [8, 0, 4, 0]]",126952
8,"[[4, 128, 4, 512], [32, 16, 1024, 0], [8, 4, 0, 0], [8, 0, 4, 0]]",126952,up,16,"[[4, 128, 4, 512], [32, 16, 1024, 0], [16, 4, 4, 0], [0, 0, 2, 0]]",126968
8,"[[4, 128, 4, 512], [32, 16, 1024, 0], [16, 4, 4, 0], [0, 0, 2, 0]]",126968,right,8,"[[4, 128, 4, 512], [2, 32, 16, 1024], [0, 0, 16, 8], [0, 0, 0, 2]]",126976
8,"[[4, 128, 4, 512], [2, 32, 16, 1024], [0, 0, 16, 8], [0, 0, 0, 2]]",126976,up,32,"[[4, 128, 4, 512], [2, 32, 32, 1024], [4, 0, 0, 8], [0, 0, 0, 2]]",127008
8,"[[4, 128, 4, 512], [2, 32, 32, 1024], [4, 0, 0, 8], [0, 0, 0, 2]]",127008,right,64,"[[4, 128, 4, 512], [0, 2, 64, 1024], [0, 4, 4, 8], [0, 0, 0, 2]]",127072
8,"[[4, 128, 4, 512], [0, 2, 64, 1024], [0, 4, 4, 8], [0, 0, 0, 2]]",127072,right,8,"[[4, 128, 4, 512], [0, 2, 64, 1024], [0, 0, 8, 8], [0, 2, 0, 2]]",127080
8,"[[4, 128, 4, 512], [0, 2, 64, 1024], [0, 0, 8, 8], [0, 2, 0, 2]]",127080,right,20,"[[4, 128, 4, 512], [0, 2, 64, 1024], [0, 0, 0, 16], [0, 4, 0, 4]]",127100
8,"[[4, 128, 4, 512], [0, 2, 64, 1024], [0, 0, 0, 16], [0, 4, 0, 4]]",127100,right,8,"[[4, 128, 4, 512], [0, 2, 64, 1024], [0, 2, 0, 16], [0, 0, 0, 8]]",127108
8,"[[4, 128, 4, 512], [0, 2, 64, 1024], [0, 2, 0, 16], [0, 0, 0, 8]]",127108,down,4,"[[0, 0, 0, 512], [2, 0, 0, 1024], [0, 128, 4, 16], [4, 4, 64, 8]]",127112
8,"[[0, 0, 0, 512], [2, 0, 0, 1024], [0, 128, 4, 16], [4, 4, 64, 8]]",127112,down,0,"[[0, 4, 0, 512], [0, 0, 0, 1024], [2, 128, 4, 16], [4, 4, 64, 8]]",127112
8,"[[0, 4, 0, 512], [0, 0, 0, 1024], [2, 128, 4, 16], [4, 4, 64, 8]]",127112,right,8,"[[0, 0, 4, 512], [2, 0, 0, 1024], [2, 128, 4, 16], [0, 8, 64, 8]]",127120
8,"[[0, 0, 4, 512], [2, 0, 0, 1024], [2, 128, 4, 16], [0, 8, 64, 8]]",127120,down,12,"[[0, 0, 0, 512], [0, 0, 4, 1024], [0, 128, 8, 16], [4, 8, 64, 8]]",127132
8,"[[0, 0, 0, 512], [0, 0, 4, 1024], [0, 128, 8, 16], [4, 8, 64, 8]]",127132,up,0,"[[4, 128, 4, 512], [0, 8, 8, 1024], [4, 0, 64, 16], [0, 0, 0, 8]]",127132
8,"[[4, 128, 4, 512], [0, 8, 8, 1024], [4, 0, 64, 16], [0, 0, 0, 8]]",127132,right,16,"[[4, 128, 4, 512], [0, 4, 16, 1024], [0, 4, 64, 16], [0, 0, 0, 8]]",127148
8,"[[4, 128, 4, 512], [0, 4, 16, 1024], [0, 4, 64, 16], [0, 0, 0, 8]]",127148,down,8,"[[0, 0, 0, 512], [2, 0, 4, 1024], [0, 128, 16, 16], [4, 8, 64, 8]]",127156
8,"[[0, 0, 0, 512], [2, 0, 4, 1024], [0, 128, 16, 16], [4, 8, 64, 8]]",127156,right,32,"[[0, 0, 0, 512], [4, 2, 4, 1024], [0, 0, 128, 32], [4, 8, 64, 8]]",127188
8,"[[0, 0, 0, 512], [4, 2, 4, 1024], [0, 0, 128, 32], [4, 8, 64, 8]]",127188,down,8,"[[0, 0, 0, 512], [4, 0, 4, 1024], [0, 2, 128, 32], [8, 8, 64, 8]]",127196
8,"[[0, 0, 0, 512], [4, 0, 4, 1024], [0, 2, 128, 32], [8, 8, 64, 8]]",127196,right,24,"[[0, 0, 0, 512], [0, 0, 8, 1024], [2, 2, 128, 32], [0, 16, 64, 8]]",127220
8,"[[0, 0, 0, 512], [0, 0, 8, 1024], [2, 2, 128, 32], [0, 16, 64, 8]]",127220,right,4,"[[2, 0, 0, 512], [0, 0, 8, 1024], [0, 4, 128, 32], [0, 16, 64, 8]]",127224
8,"[[2, 0, 0, 512], [0, 0, 8, 1024], [0, 4, 128, 32], [0, 16, 64, 8]]",127224,down,0,"[[0, 0, 0, 512], [0, 2, 8, 1024], [0, 4, 128, 32], [2, 16, 64, 8]]",127224
8,"[[0, 0, 0, 512], [0, 2, 8, 1024], [0, 4, 128, 32], [2, 16, 64, 8]]",127224,up,0,"[[2, 2, 8, 512], [0, 4, 128, 1024], [0, 16, 64, 32], [4, 0, 0, 8]]",127224
8,"[[2, 2, 8, 512], [0, 4, 128, 1024], [0, 16, 64, 32], [4, 0, 0, 8]]",127224,right,4,"[[0, 4, 8, 512], [0, 4, 128, 1024], [0, 16, 64, 32], [0, 4, 4, 8]]",127228
8,"[[0, 4, 8, 512], [0, 4, 128, 1024], [0, 16, 64, 32], [0, 4, 4, 8]]",127228,left,8,"[[4, 8, 512, 0], [4, 128, 1024, 0], [16, 64, 32, 0], [8, 8, 0, 4]]",127236
8,"[[4, 8, 512, 0], [4, 128, 1024, 0], [16, 64, 32, 0], [8, 8, 0, 4]]",127236,down,8,"[[0, 8, 0, 2], [8, 128, 512, 0], [16, 64, 1024, 0], [8, 8, 32, 4]]",127244
8,"[[0, 8, 0, 2], [8, 128, 512, 0], [16, 64, 1024, 0], [8, 8, 32, 4]]",127244,right,16,"[[0, 0, 8, 2], [0, 8, 128, 512], [0, 16, 64, 1024], [2, 16, 32, 4]]",127260
8,"[[0, 0, 8, 2], [0, 8, 128, 512], [0, 16, 64, 1024], [2, 16, 32, 4]]",127260,down,32,"[[0, 4, 8, 2], [0, 0, 128, 512], [0, 8, 64, 1024], [2, 32, 32, 4]]",127292
8,"[[0, 4, 8, 2], [0, 0, 128, 512], [0, 8, 64, 1024], [2, 32, 32, 4]]",127292,right,64,"[[0, 4, 8, 2], [0, 0, 128, 512], [2, 8, 64, 1024], [0, 2, 64, 4]]",127356
8,"[[0, 4, 8, 2], [0, 0, 128, 512], [2, 8, 64, 1024], [0, 2, 64, 4]]",127356,down,128,"[[4, 0, 0, 2], [0, 4, 8, 512], [0, 8, 128, 1024], [2, 2, 128, 4]]",127484
8,"[[4, 0, 0, 2], [0, 4, 8, 512], [0, 8, 128, 1024], [2, 2, 128, 4]]",127484,down,256,"[[0, 0, 0, 2], [2, 4, 0, 512], [4, 8, 8, 1024], [2, 2, 256, 4]]",127740
8,"[[0, 0, 0, 2], [2, 4, 0, 512], [4, 8, 8, 1024], [2, 2, 256, 4]]",127740,left,20,"[[2, 4, 0, 0], [2, 4, 512, 0], [4, 16, 1024, 0], [4, 256, 4, 0]]",127760
8,"[[2, 4, 0, 0], [2, 4, 512, 0], [4, 16, 1024, 0], [4, 256, 4, 0]]",127760,down,20,"[[0, 0, 0, 0], [0, 8, 512, 0], [4, 16, 1024, 2], [8, 256, 4, 0]]",127780
8,"[[0, 0, 0, 0], [0, 8, 512, 0], [4, 16, 1024, 2], [8, 256, 4, 0]]",127780,right,0,"[[0, 0, 0, 2], [0, 0, 8, 512], [4, 16, 1024, 2], [0, 8, 256, 4]]",127780
8,"[[0, 0, 0, 2], [0, 0, 8, 512], [4, 16, 1024, 2], [0, 8, 256, 4]]",127780,right,0,"[[0, 0, 4, 2], [0, 0, 8, 512], [4, 16, 1024, 2], [0, 8, 256, 4]]",127780
8,"[[0, 0, 4, 2], [0, 0, 8, 512], [4, 16, 1024, 2], [0, 8, 256, 4]]",127780,up,0,"[[4, 16, 4, 2], [0, 8, 8, 512], [0, 0, 1024, 2], [0, 4, 256, 4]]",127780
8,"[[4, 16, 4, 2], [0, 8, 8, 512], [0, 0, 1024, 2], [0, 4, 256, 4]]",127780,right,16,"[[4, 16, 4, 2], [0, 0, 16, 512], [2, 0, 1024, 2], [0, 4, 256, 4]]",127796
8,"[[4, 16, 4, 2], [0, 0, 16, 512], [2, 0, 1024, 2], [0, 4, 256, 4]]",127796,right,0,"[[4, 16, 4, 2], [0, 4, 16, 512], [0, 2, 1024, 2], [0, 4, 256, 4]]",127796
8,"[[4, 16, 4, 2], [0, 4, 16, 512], [0, 2, 1024, 2], [0, 4, 256, 4]]",127796,left,0,"[[4, 16, 4, 2], [4, 16, 512, 0], [2, 1024, 2, 2], [4, 256, 4, 0]]",127796
8,"[[4, 16, 4, 2], [4, 16, 512, 0], [2, 1024, 2, 2], [4, 256, 4, 0]]",127796,up,44,"[[8, 32, 4, 4], [2, 1024, 512, 0], [4, 256, 2, 0], [0, 0, 4, 2]]",127840
8,"[[8, 32, 4, 4], [2, 1024, 512, 0], [4, 256, 2, 0], [0, 0, 4, 2]]",127840,right,8,"[[4, 8, 32, 8], [0, 2, 1024, 512], [0, 4, 256, 2], [0, 0, 4, 2]]",127848
8,"[[4, 8, 32, 8], [0, 2, 1024, 512], [0, 4, 256, 2], [0, 0, 4, 2]]",127848,down,4,"[[0, 2, 32, 0], [0, 8, 1024, 8], [0, 2, 256, 512], [4, 4, 4, 4]]",127852
8,"[[0, 2, 32, 0], [0, 8, 1024, 8], [0, 2, 256, 512], [4, 4, 4, 4]]",127852,right,16,"[[0, 0, 2, 32], [4, 8, 1024, 8], [0, 2, 256, 512], [0, 0, 8, 8]]",127868
8,"[[0, 0, 2, 32], [4, 8, 1024, 8], [0, 2, 256, 512], [0, 0, 8, 8]]",127868,right,16,"[[0, 0, 2, 32], [4, 8, 1024, 8], [0, 2, 256, 512], [4, 0, 0, 16]]",127884
8,"[[0, 0, 2, 32], [4, 8, 1024, 8], [0, 2, 256, 512], [4, 0, 0, 16]]",127884,up,8,"[[8, 8, 2, 32], [0, 2, 1024, 8], [0, 0, 256, 512], [4, 0, 0, 16]]",127892
8,"[[8, 8, 2, 32], [0, 2, 1024, 8], [0, 0, 256, 512], [4, 0, 0, 16]]",127892,right,16,"[[0, 16, 2, 32], [2, 2, 1024, 8], [0, 0, 256, 512], [0, 0, 4, 16]]",127908
8,"[[0, 16, 2, 32], [2, 2, 1024, 8], [0, 0, 256, 512], [0, 0, 4, 16]]",127908,down,0,"[[0, 4, 2, 32], [0, 0, 1024, 8], [0, 16, 256, 512], [2, 2, 4, 16]]",127908
8,"[[0, 4, 2, 32], [0, 0, 1024, 8], [0, 16, 256, 512], [2, 2, 4, 16]]",127908,right,4,"[[0, 4, 2, 32], [2, 0, 1024, 8], [0, 16, 256, 512], [0, 4, 4, 16]]",127912
8,"[[0, 4, 2, 32], [2, 0, 1024, 8], [0, 16, 256, 512], [0, 4, 4, 16]]",127912,left,8,"[[4, 2, 32, 0], [2, 1024, 8, 0], [16, 256, 512, 0], [8, 16, 0, 2]]",127920
8,"[[4, 2, 32, 0], [2, 1024, 8, 0], [16, 256, 512, 0], [8, 16, 0, 2]]",127920,down,0,"[[4, 2, 0, 4], [2, 1024, 32, 0], [16, 256, 8, 0], [8, 16, 512, 2]]",127920
8,"[[4, 2, 0, 4], [2, 1024, 32, 0], [16, 256, 8, 0], [8, 16, 512, 2]]",127920,right,0,"[[4, 4, 2, 4], [0, 2, 1024, 32], [0, 16, 256, 8], [8, 16, 512, 2]]",127920
8,"[[4, 4, 2, 4], [0, 2, 1024, 32], [0, 16, 256, 8], [8, 16, 512, 2]]",127920,up,32,"[[4, 4, 2, 4], [8, 2, 1024, 32], [0, 32, 256, 8], [4, 0, 512, 2]]",127952
8,"[[4, 4, 2, 4], [8, 2, 1024, 32], [0, 32, 256, 8], [4, 0, 512, 2]]",127952,left,8,"[[8, 2, 4, 2], [8, 2, 1024, 32], [32, 256, 8, 0], [4, 512, 2, 0]]",127960
8,"[[8, 2, 4, 2], [8, 2, 1024, 32], [32, 256, 8, 0], [4, 512, 2, 0]]",127960,up,20,"[[16, 4, 4, 2], [32, 256, 1024, 32], [4, 512, 8, 0], [0, 2, 2, 0]]",127980
8,"[[16, 4, 4, 2], [32, 256, 1024, 32], [4, 512, 8, 0], [0, 2, 2, 0]]",127980,left,12,"[[16, 8, 2, 0], [32, 256, 1024, 32], [4, 512, 8, 2], [4, 0, 0, 0]]",127992
8,"[[16, 8, 2, 0], [32, 256, 1024, 32], [4, 512, 8, 2], [4, 0, 0, 0]]",127992,down,8,"[[0, 0, 0, 0], [16, 8, 2, 2], [32, 256, 1024, 32], [8, 512, 8, 2]]",128000
8,"[[0, 0, 0, 0], [16, 8, 2, 2], [32, 256, 1024, 32], [8, 512, 8, 2]]",128000,left,4,"[[4, 0, 0, 0], [16, 8, 4, 0], [32, 256, 1024, 32], [8, 512, 8, 2]]",128004
8,"[[4, 0, 0, 0], [16, 8, 4, 0], [32, 256, 1024, 32], [8, 512, 8, 2]]",128004,right,0,"[[0, 4, 0, 4], [0, 16, 8, 4], [32, 256, 1024, 32], [8, 512, 8, 2]]",128004
8,"[[0, 4, 0, 4], [0, 16, 8, 4], [32, 256, 1024, 32], [8, 512, 8, 2]]",128004,down,8,"[[0, 4, 0, 0], [2, 16, 8, 8], [32, 256, 1024, 32], [8, 512, 8, 2]]",128012
8,"[[0, 4, 0, 0], [2, 16, 8, 8], [32, 256, 1024, 32], [8, 512, 8, 2]]",128012,right,16,"[[0, 4, 0, 4], [0, 2, 16, 16], [32, 256, 1024, 32], [8, 512, 8, 2]]",128028
8,"[[0, 4, 0, 4], [0, 2, 16, 16], [32, 256, 1024, 32], [8, 512, 8, 2]]",128028,right,40,"[[0, 4, 0, 8], [0, 0, 2, 32], [32, 256, 1024, 32], [8, 512, 8, 2]]",128068
8,"[[0, 4, 0, 8], [0, 0, 2, 32], [32, 256, 1024, 32], [8, 512, 8, 2]]",128068,down,64,"[[0, 0, 4, 0], [0, 4, 2, 8], [32, 256, 1024, 64], [8, 512, 8, 2]]",128132
8,"[[0, 0, 4, 0], [0, 4, 2, 8], [32, 256, 1024, 64], [8, 512, 8, 2]]",128132,up,0,"[[32, 4, 4, 8], [8, 256, 2, 64], [0, 512, 1024, 2], [0, 2, 8, 0]]",128132
8,"[[32, 4, 4, 8], [8, 256, 2, 64], [0, 512, 1024, 2], [0, 2, 8, 0]]",128132,left,8,"[[32, 8, 8, 0], [8, 256, 2, 64], [512, 1024, 2, 0], [2, 8, 4, 0]]",128140
8,"[[32, 8, 8, 0], [8, 256, 2, 64], [512, 1024, 2, 0], [2, 8, 4, 0]]",128140,left,16,"[[32, 16, 4, 0], [8, 256, 2, 64], [512, 1024, 2, 0], [2, 8, 4, 0]]",128156
8,"[[32, 16, 4, 0], [8, 256, 2, 64], [512, 1024, 2, 0], [2, 8, 4, 0]]",128156,down,4,"[[32, 16, 0, 0], [8, 256, 4, 0], [512, 1024, 4, 4], [2, 8, 4, 64]]",128160
8,"[[32, 16, 0, 0], [8, 256, 4, 0], [512, 1024, 4, 4], [2, 8, 4, 64]]",128160,down,8,"[[32, 16, 0, 0], [8, 256, 2, 0], [512, 1024, 4, 4], [2, 8, 8, 64]]",128168
8,"[[32, 16, 0, 0], [8, 256, 2, 0], [512, 1024, 4, 4], [2, 8, 8, 64]]",128168,left,24,"[[32, 16, 0, 0], [8, 256, 2, 0], [512, 1024, 8, 2], [2, 16, 64, 0]]",128192
8,"[[32, 16, 0, 0], [8, 256, 2, 0], [512, 1024, 8, 2], [2, 16, 64, 0]]",128192,up,0,"[[32, 16, 2, 2], [8, 256, 8, 0], [512, 1024, 64, 0], [2, 16, 0, 4]]",128192
8,"[[32, 16, 2, 2], [8, 256, 8, 0], [512, 1024, 64, 0], [2, 16, 0, 4]]",128192,left,4,"[[32, 16, 4, 0], [8, 256, 8, 0], [512, 1024, 64, 0], [2, 16, 4, 2]]",128196
8,"[[32, 16, 4, 0], [8, 256, 8, 0], [512, 1024, 64, 0], [2, 16, 4, 2]]",128196,left,0,"[[32, 16, 4, 0], [8, 256, 8, 0], [512, 1024, 64, 2], [2, 16, 4, 2]]",128196
8,"[[32, 16, 4, 0], [8, 256, 8, 0], [512, 1024, 64, 2], [2, 16, 4, 2]]",128196,up,4,"[[32, 16, 4, 4], [8, 256, 8, 2], [512, 1024, 64, 0], [2, 16, 4, 0]]",128200
8,"[[32, 16, 4, 4], [8, 256, 8, 2], [512, 1024, 64, 0], [2, 16, 4, 0]]",128200,left,8,"[[32, 16, 8, 2], [8, 256, 8, 2], [512, 1024, 64, 0], [2, 16, 4, 0]]",128208
8,"[[32, 16, 8, 2], [8, 256, 8, 2], [512, 1024, 64, 0], [2, 16, 4, 0]]",128208,up,20,"[[32, 16, 16, 4], [8, 256, 64, 4], [512, 1024, 4, 0], [2, 16, 0, 0]]",128228
8,"[[32, 16, 16, 4], [8, 256, 64, 4], [512, 1024, 4, 0], [2, 16, 0, 0]]",128228,left,32,"[[32, 32, 4, 2], [8, 256, 64, 4], [512, 1024, 4, 0], [2, 16, 0, 0]]",128260
8,"[[32, 32, 4, 2], [8, 256, 64, 4], [512, 1024, 4, 0], [2, 16, 0, 0]]",128260,right,64,"[[0, 64, 4, 2], [8, 256, 64, 4], [2, 512, 1024, 4], [0, 0, 2, 16]]",128324
8,"[[0, 64, 4, 2], [8, 256, 64, 4], [2, 512, 1024, 4], [0, 0, 2, 16]]",128324,down,8,"[[0, 2, 4, 0], [0, 64, 64, 2], [8, 256, 1024, 8], [2, 512, 2, 16]]",128332
8,"[[0, 2, 4, 0], [0, 64, 64, 2], [8, 256, 1024, 8], [2, 512, 2, 16]]",128332,left,128,"[[2, 4, 0, 2], [128, 2, 0, 0], [8, 256, 1024, 8], [2, 512, 2, 16]]",128460
8,"[[2, 4, 0, 2], [128, 2, 0, 0], [8, 256, 1024, 8], [2, 512, 2, 16]]",128460,right,0,"[[0, 2, 4, 2], [2, 0, 128, 2], [8, 256, 1024, 8], [2, 512, 2, 16]]",128460
8,"[[0, 2, 4, 2], [2, 0, 128, 2], [8, 256, 1024, 8], [2, 512, 2, 16]]",128460,up,4,"[[2, 2, 4, 4], [8, 256, 128, 8], [2, 512, 1024, 16], [4, 0, 2, 0]]",128464
8,"[[2, 2, 4, 4], [8, 256, 128, 8], [2, 512, 1024, 16], [4, 0, 2, 0]]",128464,right,12,"[[0, 0, 4, 8], [8, 256, 128, 8], [2, 512, 1024, 16], [4, 0, 4, 2]]",128476
8,"[[0, 0, 4, 8], [8, 256, 128, 8], [2, 512, 1024, 16], [4, 0, 4, 2]]",128476,up,16,"[[8, 256, 4, 16], [2, 512, 128, 16], [4, 0, 1024, 2], [2, 0, 4, 0]]",128492
8,"[[8, 256, 4, 16], [2, 512, 128, 16], [4, 0, 1024, 2], [2, 0, 4, 0]]",128492,down,32,"[[8, 2, 4, 0], [2, 0, 128, 0], [4, 256, 1024, 32], [2, 512, 4, 2]]",128524
8,"[[8, 2, 4, 0], [2, 0, 128, 0], [4, 256, 1024, 32], [2, 512, 4, 2]]",128524,down,0,"[[8, 4, 4, 0], [2, 2, 128, 0], [4, 256, 1024, 32], [2, 512, 4, 2]]",128524
8,"[[8, 4, 4, 0], [2, 2, 128, 0], [4, 256, 1024, 32], [2, 512, 4, 2]]",128524,right,12,"[[0, 4, 8, 8], [0, 0, 4, 128], [4, 256, 1024, 32], [2, 512, 4, 2]]",128536
8,"[[0, 4, 8, 8], [0, 0, 4, 128], [4, 256, 1024, 32], [2, 512, 4, 2]]",128536,right,16,"[[0, 0, 4, 16], [4, 0, 4, 128], [4, 256, 1024, 32], [2, 512, 4, 2]]",128552
8,"[[0, 0, 4, 16], [4, 0, 4, 128], [4, 256, 1024, 32], [2, 512, 4, 2]]",128552,up,16,"[[8, 256, 8, 16], [2, 512, 1024, 128], [0, 0, 4, 32], [2, 0, 0, 2]]",128568
8,"[[8, 256, 8, 16], [2, 512, 1024, 128], [0, 0, 4, 32], [2, 0, 0, 2]]",128568,right,4,"[[8, 256, 8, 16], [2, 512, 1024, 128], [0, 0, 4, 32], [0, 0, 4, 4]]",128572
8,"[[8, 256, 8, 16], [2, 512, 1024, 128], [0, 0, 4, 32], [0, 0, 4, 4]]",128572,up,8,"[[8, 256, 8, 16], [2, 512, 1024, 128], [0, 0, 8, 32], [2, 0, 0, 4]]",128580
8,"[[8, 256, 8, 16], [2, 512, 1024, 128], [0, 0, 8, 32], [2, 0, 0, 4]]",128580,up,4,"[[8, 256, 8, 16], [4, 512, 1024, 128], [4, 0, 8, 32], [0, 0, 0, 4]]",128584
8,"[[8, 256, 8, 16], [4, 512, 1024, 128], [4, 0, 8, 32], [0, 0, 0, 4]]",128584,up,8,"[[8, 256, 8, 16], [8, 512, 1024, 128], [0, 2, 8, 32], [0, 0, 0, 4]]",128592
8,"[[8, 256, 8, 16], [8, 512, 1024, 128], [0, 2, 8, 32], [0, 0, 0, 4]]",128592,up,16,"[[16, 256, 8, 16], [0, 512, 1024, 128], [0, 2, 8, 32], [2, 0, 0, 4]]",128608
8,"[[16, 256, 8, 16], [0, 512, 1024, 128], [0, 2, 8, 32], [2, 0, 0, 4]]",128608,left,0,"[[16, 256, 8, 16], [512, 1024, 128, 0], [2, 8, 32, 4], [2, 4, 0, 0]]",128608
8,"[[16, 256, 8, 16], [512, 1024, 128, 0], [2, 8, 32, 4], [2, 4, 0, 0]]",128608,down,4,"[[4, 256, 0, 0], [16, 1024, 8, 0], [512, 8, 128, 16], [4, 4, 32, 4]]",128612
8,"[[4, 256, 0, 0], [16, 1024, 8, 0], [512, 8, 128, 16], [4, 4, 32, 4]]",128612,right,8,"[[0, 0, 4, 256], [4, 16, 1024, 8], [512, 8, 128, 16], [0, 8, 32, 4]]",128620
8,"[[0, 0, 4, 256], [4, 16, 1024, 8], [512, 8, 128, 16], [0, 8, 32, 4]]",128620,down,16,"[[0, 0, 4, 256], [4, 0, 1024, 8], [4, 16, 128, 16], [512, 16, 32, 4]]",128636
8,"[[0, 0, 4, 256], [4, 0, 1024, 8], [4, 16, 128, 16], [512, 16, 32, 4]]",128636,down,40,"[[0, 0, 4, 256], [0, 4, 1024, 8], [8, 0, 128, 16], [512, 32, 32, 4]]",128676
8,"[[0, 0, 4, 256], [0, 4, 1024, 8], [8, 0, 128, 16], [512, 32, 32, 4]]",128676,left,64,"[[4, 256, 0, 4], [4, 1024, 8, 0], [8, 128, 16, 0], [512, 64, 4, 0]]",128740
8,"[[4, 256, 0, 4], [4, 1024, 8, 0], [8, 128, 16, 0], [512, 64, 4, 0]]",128740,up,8,"[[8, 256, 8, 4], [8, 1024, 16, 0], [512, 128, 4, 0], [2, 64, 0, 0]]",128748
8,"[[8, 256, 8, 4], [8, 1024, 16, 0], [512, 128, 4, 0], [2, 64, 0, 0]]",128748,up,16,"[[16, 256, 8, 4], [512, 1024, 16, 0], [2, 128, 4, 0], [0, 64, 0, 4]]",128764
8,"[[16, 256, 8, 4], [512, 1024, 16, 0], [2, 128, 4, 0], [0, 64, 0, 4]]",128764,up,8,"[[16, 256, 8, 8], [512, 1024, 16, 0], [2, 128, 4, 2], [0, 64, 0, 0]]",128772
8,"[[16, 256, 8, 8], [512, 1024, 16, 0], [2, 128, 4, 2], [0, 64, 0, 0]]",128772,right,16,"[[0, 16, 256, 16], [0, 512, 1024, 16], [2, 128, 4, 2], [0, 0, 2, 64]]",128788
8,"[[0, 16, 256, 16], [0, 512, 1024, 16], [2, 128, 4, 2], [0, 0, 2, 64]]",128788,up,32,"[[2, 16, 256, 32], [0, 512, 1024, 2], [0, 128, 4, 64], [0, 0, 2, 4]]",128820
8,"[[2, 16, 256, 32], [0, 512, 1024, 2], [0, 128, 4, 64], [0, 0, 2, 4]]",128820,left,0,"[[2, 16, 256, 32], [512, 1024, 2, 0], [128, 4, 64, 0], [2, 4, 2, 0]]",128820
8,"[[2, 16, 256, 32], [512, 1024, 2, 0], [128, 4, 64, 0], [2, 4, 2, 0]]",128820,up,8,"[[2, 16, 256, 32], [512, 1024, 2, 2], [128, 8, 64, 0], [2, 0, 2, 0]]",128828
8,"[[2, 16, 256, 32], [512, 1024, 2, 2], [128, 8, 64, 0], [2, 0, 2, 0]]",128828,left,8,"[[2, 16, 256, 32], [512, 1024, 4, 0], [128, 8, 64, 0], [4, 0, 0, 4]]",128836
8,"[[2, 16, 256, 32], [512, 1024, 4, 0], [128, 8, 64, 0], [4, 0, 0, 4]]",128836,left,8,"[[2, 16, 256, 32], [512, 1024, 4, 0], [128, 8, 64, 2], [8, 0, 0, 0]]",128844
8,"[[2, 16, 256, 32], [512, 1024, 4, 0], [128, 8, 64, 2], [8, 0, 0, 0]]",128844,down,0,"[[2, 0, 0, 4], [512, 16, 256, 0], [128, 1024, 4, 32], [8, 8, 64, 2]]",128844
8,"[[2, 0, 0, 4], [512, 16, 256, 0], [128, 1024, 4, 32], [8, 8, 64, 2]]",128844,left,16,"[[2, 4, 0, 0], [512, 16, 256, 2], [128, 1024, 4, 32], [16, 64, 2, 0]]",128860
8,"[[2, 4, 0, 0], [512, 16, 256, 2], [128, 1024, 4, 32], [16, 64, 2, 0]]",128860,down,0,"[[2, 4, 0, 0], [512, 16, 256, 4], [128, 1024, 4, 2], [16, 64, 2, 32]]",128860
8,"[[2, 4, 0, 0], [512, 16, 256, 4], [128, 1024, 4, 2], [16, 64, 2, 32]]",128860,right,0,"[[0, 4, 2, 4], [512, 16, 256, 4], [128, 1024, 4, 2], [16, 64, 2, 32]]",128860
8,"[[0, 4, 2, 4], [512, 16, 256, 4], [128, 1024, 4, 2], [16, 64, 2, 32]]",128860,down,8,"[[0, 4, 2, 2], [512, 16, 256, 8], [128, 1024, 4, 2], [16, 64, 2, 32]]",128868
8,"[[0, 4, 2, 2], [512, 16, 256, 8], [128, 1024, 4, 2], [16, 64, 2, 32]]",128868,right,4,"[[4, 0, 4, 4], [512, 16, 256, 8], [128, 1024, 4, 2], [16, 64, 2, 32]]",128872
8,"[[4, 0, 4, 4], [512, 16, 256, 8], [128, 1024, 4, 2], [16, 64, 2, 32]]",128872,right,8,"[[4, 0, 4, 8], [512, 16, 256, 8], [128, 1024, 4, 2], [16, 64, 2, 32]]",128880
8,"[[4, 0, 4, 8], [512, 16, 256, 8], [128, 1024, 4, 2], [16, 64, 2, 32]]",128880,right,8,"[[2, 0, 8, 8], [512, 16, 256, 8], [128, 1024, 4, 2], [16, 64, 2, 32]]",128888
8,"[[2, 0, 8, 8], [512, 16, 256, 8], [128, 1024, 4, 2], [16, 64, 2, 32]]",128888,left,16,"[[2, 16, 0, 2], [512, 16, 256, 8], [128, 1024, 4, 2], [16, 64, 2, 32]]",128904
8,"[[2, 16, 0, 2], [512, 16, 256, 8], [128, 1024, 4, 2], [16, 64, 2, 32]]",128904,up,32,"[[2, 32, 256, 2], [512, 1024, 4, 8], [128, 64, 2, 2], [16, 4, 0, 32]]",128936
8,"[[2, 32, 256, 2], [512, 1024, 4, 8], [128, 64, 2, 2], [16, 4, 0, 32]]",128936,left,4,"[[2, 32, 256, 2], [512, 1024, 4, 8], [128, 64, 4, 0], [16, 4, 32, 4]]",128940
8,"[[2, 32, 256, 2], [512, 1024, 4, 8], [128, 64, 4, 0], [16, 4, 32, 4]]",128940,up,8,"[[2, 32, 256, 2], [512, 1024, 8, 8], [128, 64, 32, 4], [16, 4, 2, 0]]",128948
8,"[[2, 32, 256, 2], [512, 1024, 8, 8], [128, 64, 32, 4], [16, 4, 2, 0]]",128948,left,16,"[[2, 32, 256, 2], [512, 1024, 16, 2], [128, 64, 32, 4], [16, 4, 2, 0]]",128964
8,"[[2, 32, 256, 2], [512, 1024, 16, 2], [128, 64, 32, 4], [16, 4, 2, 0]]",128964,up,4,"[[2, 32, 256, 4], [512, 1024, 16, 4], [128, 64, 32, 4], [16, 4, 2, 0]]",128968
8,"[[2, 32, 256, 4], [512, 1024, 16, 4], [128, 64, 32, 4], [16, 4, 2, 0]]",128968,left,0,"[[2, 32, 256, 4], [512, 1024, 16, 4], [128, 64, 32, 4], [16, 4, 2, 4]]",128968
8,"[[2, 32, 256, 4], [512, 1024, 16, 4], [128, 64, 32, 4], [16, 4, 2, 4]]",128968,down,16,"[[2, 32, 256, 0], [512, 1024, 16, 4], [128, 64, 32, 8], [16, 4, 2, 8]]",128984
8,"[[2, 32, 256, 0], [512, 1024, 16, 4], [128, 64, 32, 8], [16, 4, 2, 8]]",128984,up,16,"[[2, 32, 256, 4], [512, 1024, 16, 16], [128, 64, 32, 2], [16, 4, 2, 0]]",129000
8,"[[2, 32, 256, 4], [512, 1024, 16, 16], [128, 64, 32, 2], [16, 4, 2, 0]]",129000,left,32,"[[2, 32, 256, 4], [512, 1024, 32, 4], [128, 64, 32, 2], [16, 4, 2, 0]]",129032
8,"[[2, 32, 256, 4], [512, 1024, 32, 4], [128, 64, 32, 2], [16, 4, 2, 0]]",129032,down,72,"[[2, 32, 4, 0], [512, 1024, 256, 0], [128, 64, 64, 8], [16, 4, 2, 2]]",129104
8,"[[2, 32, 4, 0], [512, 1024, 256, 0], [128, 64, 64, 8], [16, 4, 2, 2]]",129104,right,132,"[[0, 2, 32, 4], [0, 512, 1024, 256], [0, 128, 128, 8], [2, 16, 4, 4]]",129236
8,"[[0, 2, 32, 4], [0, 512, 1024, 256], [0, 128, 128, 8], [2, 16, 4, 4]]",129236,right,264,"[[0, 2, 32, 4], [0, 512, 1024, 256], [2, 0, 256, 8], [0, 2, 16, 8]]",129500
8,"[[0, 2, 32, 4], [0, 512, 1024, 256], [2, 0, 256, 8], [0, 2, 16, 8]]",129500,down,16,"[[0, 0, 32, 4], [0, 2, 1024, 4], [0, 512, 256, 256], [2, 2, 16, 16]]",129516
8,"[[0, 0, 32, 4], [0, 2, 1024, 4], [0, 512, 256, 256], [2, 2, 16, 16]]",129516,left,548,"[[32, 4, 0, 0], [2, 1024, 4, 0], [512, 512, 0, 0], [4, 32, 4, 0]]",130064
8,"[[32, 4, 0, 0], [2, 1024, 4, 0], [512, 512, 0, 0], [4, 32, 4, 0]]",130064,left,1024,"[[32, 4, 0, 0], [2, 1024, 4, 0], [1024, 0, 4, 0], [4, 32, 4, 0]]",131088
8,"[[32, 4, 0, 0], [2, 1024, 4, 0], [1024, 0, 4, 0], [4, 32, 4, 0]]",131088,right,0,"[[2, 0, 32, 4], [0, 2, 1024, 4], [0, 0, 1024, 4], [0, 4, 32, 4]]",131088
8,"[[2, 0, 32, 4], [0, 2, 1024, 4], [0, 0, 1024, 4], [0, 4, 32, 4]]",131088,up,2064,"[[2, 2, 32, 8], [0, 4, 2048, 8], [0, 0, 32, 0], [4, 0, 0, 0]]",133152
