13,"[[0, 0, 0, 0], [2, 0, 0, 0], [0, 0, 0, 2], [0, 0, 0, 0]]",0,right,0,"[[4, 0, 0, 0], [0, 0, 0, 2], [0, 0, 0, 2], [0, 0, 0, 0]]",0
13,"[[4, 0, 0, 0], [0, 0, 0, 2], [0, 0, 0, 2], [0, 0, 0, 0]]",0,down,4,"[[0, 0, 0, 0], [0, 0, 0, 0], [0, 0, 0, 0], [4, 4, 0, 4]]",4
13,"[[0, 0, 0, 0], [0, 0, 0, 0], [0, 0, 0, 0], [4, 4, 0, 4]]",4,left,8,"[[0, 0, 0, 0], [0, 0, 0, 0], [0, 2, 0, 0], [8, 4, 0, 0]]",12
13,"[[0, 0, 0, 0], [0, 0, 0, 0], [0, 2, 0, 0], [8, 4, 0, 0]]",12,left,0,"[[0, 0, 0, 0], [0, 0, 0, 2], [2, 0, 0, 0], [8, 4, 0, 0]]",12
13,"[[0, 0, 0, 0], [0, 0, 0, 2], [2, 0, 0, 0], [8, 4, 0, 0]]",12,left,0,"[[0, 0, 0, 0], [2, 0, 0, 4], [2, 0, 0, 0], [8, 4, 0, 0]]",12
13,"[[0, 0, 0, 0], [2, 0, 0, 4], [2, 0, 0, 0], [8, 4, 0, 0]]",12,down,4,"[[0, 0, 0, 0], [0, 0, 0, 0], [4, 2, 0, 0], [8, 4, 0, 4]]",16
13,"[[0, 0, 0, 0], [0, 0, 0, 0], [4, 2, 0, 0], [8, 4, 0, 4]]",16,left,8,"[[0, 0, 0, 0], [4, 0, 0, 0], [4, 2, 0, 0], [8, 8, 0, 0]]",24
13,"[[0, 0, 0, 0], [4, 0, 0, 0], [4, 2, 0, 0], [8, 8, 0, 0]]",24,left,16,"[[0, 0, 0, 0], [4, 0, 0, 0], [4, 2, 0, 0], [16, 0, 4, 0]]",40
13,"[[0, 0, 0, 0], [4, 0, 0, 0], [4, 2, 0, 0], [16, 0, 4, 0]]",40,down,8,"[[0, 0, 0, 0], [0, 2, 0, 0], [8, 0, 0, 0], [16, 2, 4, 0]]",48
13,"[[0, 0, 0, 0], [0, 2, 0, 0], [8, 0, 0, 0], [16, 2, 4, 0]]",48,down,4,"[[0, 0, 0, 0], [0, 0, 0, 0], [8, 0, 0, 0], [16, 4, 4, 4]]",52
13,"[[0, 0, 0, 0], [0, 0, 0, 0], [8, 0, 0, 0], [16, 4, 4, 4]]",52,right,8,"[[0, 0, 0, 0], [0, 0, 0, 0], [0, 2, 0, 8], [0, 16, 4, 8]]",60
13,"[[0, 0, 0, 0], [0, 0, 0, 0], [0, 2, 0, 8], [0, 16, 4, 8]]",60,up,16,"[[0, 2, 4, 16], [0, 16, 0, 0], [0, 0, 0, 0], [0, 2, 0, 0]]",76
13,"[[0, 2, 4, 16], [0, 16, 0, 0], [0, 0, 0, 0], [0, 2, 0, 0]]",76,right,0,"[[0, 2, 4, 16], [0, 0, 0, 16], [0, 0, 0, 0], [4, 0, 0, 2]]",76
13,"[[0, 2, 4, 16], [0, 0, 0, 16], [0, 0, 0, 0], [4, 0, 0, 2]]",76,up,32,"[[4, 2, 4, 32], [0, 0, 2, 2], [0, 0, 0, 0], [0, 0, 0, 0]]",108
13,"[[4, 2, 4, 32], [0, 0, 2, 2], [0, 0, 0, 0], [0, 0, 0, 0]]",108,left,4,"[[4, 2, 4, 32], [4, 0, 0, 0], [0, 0, 0, 0], [0, 0, 0, 2]]",112
13,"[[4, 2, 4, 32], [4, 0, 0, 0], [0, 0, 0, 0], [0, 0, 0, 2]]",112,up,8,"[[8, 2, 4, 32], [0, 0, 0, 2], [0, 0, 2, 0], [0, 0, 0, 0]]",120
13,"[[8, 2, 4, 32], [0, 0, 0, 2], [0, 0, 2, 0], [0, 0, 0, 0]]",120,down,0,"[[0, 4, 0, 0], [0, 0, 0, 0], [0, 0, 4, 32], [8, 2, 2, 2]]",120
13,"[[0, 4, 0, 0], [0, 0, 0, 0], [0, 0, 4, 32], [8, 2, 2, 2]]",120,left,4,"[[4, 0, 0, 0], [4, 0, 0, 0], [4, 32, 0, 0], [8, 4, 2, 0]]",124
13,"[[4, 0, 0, 0], [4, 0, 0, 0], [4, 32, 0, 0], [8, 4, 2, 0]]",124,down,8,"[[0, 0, 0, 0], [4, 4, 0, 0], [8, 32, 0, 0], [8, 4, 2, 0]]",132
13,"[[0, 0, 0, 0], [4, 4, 0, 0], [8, 32, 0, 0], [8, 4, 2, 0]]",132,down,16,"[[0, 0, 0, 0], [0, 4, 0, 0], [4, 32, 0, 0], [16, 4, 2, 4]]",148
13,"[[0, 0, 0, 0], [0, 4, 0, 0], [4, 32, 0, 0], [16, 4, 2, 4]]",148,up,0,"[[4, 4, 2, 4], [16, 32, 0, 0], [0, 4, 0, 0], [0, 0, 2, 0]]",148
13,"[[4, 4, 2, 4], [16, 32, 0, 0], [0, 4, 0, 0], [0, 0, 2, 0]]",148,up,4,"[[4, 4, 4, 4], [16, 32, 0, 0], [0, 4, 0, 4], [0, 0, 0, 0]]",152
13,"[[4, 4, 4, 4], [16, 32, 0, 0], [0, 4, 0, 4], [0, 0, 0, 0]]",152,left,24,"[[8, 8, 0, 0], [16, 32, 0, 0], [8, 0, 0, 0], [4, 0, 0, 0]]",176
13,"[[8, 8, 0, 0], [16, 32, 0, 0], [8, 0, 0, 0], [4, 0, 0, 0]]",176,left,16,"[[16, 0, 0, 0], [16, 32, 0, 0], [8, 2, 0, 0], [4, 0, 0, 0]]",192
13,"[[16, 0, 0, 0], [16, 32, 0, 0], [8, 2, 0, 0], [4, 0, 0, 0]]",192,up,32,"[[32, 32, 0, 0], [8, 2, 0, 0], [4, 0, 4, 0], [0, 0, 0, 0]]",224
13,"[[32, 32, 0, 0], [8, 2, 0, 0], [4, 0, 4, 0], [0, 0, 0, 0]]",224,left,72,"[[64, 0, 0, 0], [8, 2, 0, 0], [8, 0, 0, 0], [0, 0, 0, 2]]",296
13,"[[64, 0, 0, 0], [8, 2, 0, 0], [8, 0, 0, 0], [0, 0, 0, 2]]",296,down,16,"[[0, 0, 0, 0], [0, 0, 0, 0], [64, 0, 2, 0], [16, 2, 0, 2]]",312
13,"[[0, 0, 0, 0], [0, 0, 0, 0], [64, 0, 2, 0], [16, 2, 0, 2]]",312,left,4,"[[0, 0, 0, 0], [0, 0, 0, 0], [64, 2, 0, 0], [16, 4, 0, 2]]",316
13,"[[0, 0, 0, 0], [0, 0, 0, 0], [64, 2, 0, 0], [16, 4, 0, 2]]",316,up,0,"[[64, 2, 0, 2], [16, 4, 0, 0], [0, 0, 0, 4], [0, 0, 0, 0]]",316
13,"[[64, 2, 0, 2], [16, 4, 0, 0], [0, 0, 0, 4], [0, 0, 0, 0]]",316,left,4,"[[64, 4, 0, 2], [16, 4, 0, 0], [4, 0, 0, 0], [0, 0, 0, 0]]",320
13,"[[64, 4, 0, 2], [16, 4, 0, 0], [4, 0, 0, 0], [0, 0, 0, 0]]",320,up,8,"[[64, 8, 0, 2], [16, 0, 0, 0], [4, 0, 0, 0], [0, 0, 0, 4]]",328
13,"[[64, 8, 0, 2], [16, 0, 0, 0], [4, 0, 0, 0], [0, 0, 0, 4]]",328,left,0,"[[64, 8, 2, 0], [16, 0, 4, 0], [4, 0, 0, 0], [4, 0, 0, 0]]",328
13,"[[64, 8, 2, 0], [16, 0, 4, 0], [4, 0, 0, 0], [4, 0, 0, 0]]",328,down,8,"[[0, 0, 0, 0], [64, 0, 0, 0], [16, 4, 2, 0], [8, 8, 4, 0]]",336
13,"[[0, 0, 0, 0], [64, 0, 0, 0], [16, 4, 2, 0], [8, 8, 4, 0]]",336,left,16,"[[0, 0, 0, 0], [64, 2, 0, 0], [16, 4, 2, 0], [16, 4, 0, 0]]",352
13,"[[0, 0, 0, 0], [64, 2, 0, 0], [16, 4, 2, 0], [16, 4, 0, 0]]",352,up,40,"[[64, 2, 2, 0], [32, 8, 0, 0], [0, 0, 4, 0], [0, 0, 0, 0]]",392
13,"[[64, 2, 2, 0], [32, 8, 0, 0], [0, 0, 4, 0], [0, 0, 0, 0]]",392,left,4,"[[64, 4, 0, 0], [32, 8, 0, 0], [4, 0, 0, 0], [0, 0, 0, 4]]",396
13,"[[64, 4, 0, 0], [32, 8, 0, 0], [4, 0, 0, 0], [0, 0, 0, 4]]",396,left,0,"[[64, 4, 0, 2], [32, 8, 0, 0], [4, 0, 0, 0], [4, 0, 0, 0]]",396
13,"[[64, 4, 0, 2], [32, 8, 0, 0], [4, 0, 0, 0], [4, 0, 0, 0]]",396,down,8,"[[0, 0, 0, 0], [64, 0, 0, 4], [32, 4, 0, 0], [8, 8, 0, 2]]",404
13,"[[0, 0, 0, 0], [64, 0, 0, 4], [32, 4, 0, 0], [8, 8, 0, 2]]",404,left,16,"[[0, 0, 0, 2], [64, 4, 0, 0], [32, 4, 0, 0], [16, 2, 0, 0]]",420
13,"[[0, 0, 0, 2], [64, 4, 0, 0], [32, 4, 0, 0], [16, 2, 0, 0]]",420,down,8,"[[0, 2, 0, 0], [64, 0, 0, 0], [32, 8, 0, 0], [16, 2, 0, 2]]",428
13,"[[0, 2, 0, 0], [64, 0, 0, 0], [32, 8, 0, 0], [16, 2, 0, 2]]",428,left,4,"[[2, 0, 0, 0], [64, 0, 0, 0], [32, 8, 2, 0], [16, 4, 0, 0]]",432
13,"[[2, 0, 0, 0], [64, 0, 0, 0], [32, 8, 2, 0], [16, 4, 0, 0]]",432,up,0,"[[2, 8, 2, 0], [64, 4, 0, 0], [32, 0, 0, 0], [16, 2, 0, 0]]",432
13,"[[2, 8, 2, 0], [64, 4, 0, 0], [32, 0, 0, 0], [16, 2, 0, 0]]",432,down,0,"[[2, 0, 0, 0], [64, 8, 0, 0], [32, 4, 0, 0], [16, 2, 2, 2]]",432
13,"[[2, 0, 0, 0], [64, 8, 0, 0], [32, 4, 0, 0], [16, 2, 2, 2]]",432,left,4,"[[2, 0, 0, 2], [64, 8, 0, 0], [32, 4, 0, 0], [16, 4, 2, 0]]",436
13,"[[2, 0, 0, 2], [64, 8, 0, 0], [32, 4, 0, 0], [16, 4, 2, 0]]",436,down,8,"[[2, 0, 0, 0], [64, 0, 0, 0], [32, 8, 0, 4], [16, 8, 2, 2]]",444
13,"[[2, 0, 0, 0], [64, 0, 0, 0], [32, 8, 0, 4], [16, 8, 2, 2]]",444,down,16,"[[2, 0, 0, 0], [64, 0, 4, 0], [32, 0, 0, 4], [16, 16, 2, 2]]",460
13,"[[2, 0, 0, 0], [64, 0, 4, 0], [32, 0, 0, 4], [16, 16, 2, 2]]",460,left,36,"[[2, 0, 0, 0], [64, 4, 4, 0], [32, 4, 0, 0], [32, 4, 0, 0]]",496
13,"[[2, 0, 0, 0], [64, 4, 4, 0], [32, 4, 0, 0], [32, 4, 0, 0]]",496,up,72,"[[2, 8, 4, 0], [64, 4, 0, 0], [64, 0, 4, 0], [0, 0, 0, 0]]",568
13,"[[2, 8, 4, 0], [64, 4, 0, 0], [64, 0, 4, 0], [0, 0, 0, 0]]",568,up,136,"[[2, 8, 8, 0], [128, 4, 0, 0], [0, 2, 0, 0], [0, 0, 0, 0]]",704
13,"[[2, 8, 8, 0], [128, 4, 0, 0], [0, 2, 0, 0], [0, 0, 0, 0]]",704,left,16,"[[2, 16, 0, 0], [128, 4, 0, 0], [2, 2, 0, 0], [0, 0, 0, 0]]",720
13,"[[2, 16, 0, 0], [128, 4, 0, 0], [2, 2, 0, 0], [0, 0, 0, 0]]",720,right,4,"[[0, 0, 2, 16], [0, 0, 128, 4], [0, 4, 0, 4], [0, 0, 0, 0]]",724
13,"[[0, 0, 2, 16], [0, 0, 128, 4], [0, 4, 0, 4], [0, 0, 0, 0]]",724,left,8,"[[2, 16, 2, 0], [128, 4, 0, 0], [8, 0, 0, 0], [0, 0, 0, 0]]",732
13,"[[2, 16, 2, 0], [128, 4, 0, 0], [8, 0, 0, 0], [0, 0, 0, 0]]",732,up,0,"[[2, 16, 2, 2], [128, 4, 0, 0], [8, 0, 0, 0], [0, 0, 0, 0]]",732
13,"[[2, 16, 2, 2], [128, 4, 0, 0], [8, 0, 0, 0], [0, 0, 0, 0]]",732,right,4,"[[0, 2, 16, 4], [2, 0, 128, 4], [0, 0, 0, 8], [0, 0, 0, 0]]",736
13,"[[0, 2, 16, 4], [2, 0, 128, 4], [0, 0, 0, 8], [0, 0, 0, 0]]",736,up,8,"[[2, 2, 16, 8], [0, 0, 128, 8], [0, 0, 0, 0], [4, 0, 0, 0]]",744
13,"[[2, 2, 16, 8], [0, 0, 128, 8], [0, 0, 0, 0], [4, 0, 0, 0]]",744,up,16,"[[2, 2, 16, 16], [4, 0, 128, 0], [0, 0, 0, 0], [0, 0, 0, 2]]",760
13,"[[2, 2, 16, 16], [4, 0, 128, 0], [0, 0, 0, 0], [0, 0, 0, 2]]",760,left,36,"[[4, 32, 0, 2], [4, 128, 0, 0], [0, 0, 0, 0], [2, 0, 0, 0]]",796
13,"[[4, 32, 0, 2], [4, 128, 0, 0], [0, 0, 0, 0], [2, 0, 0, 0]]",796,down,8,"[[4, 0, 0, 0], [0, 0, 0, 0], [8, 32, 0, 0], [2, 128, 0, 2]]",804
13,"[[4, 0, 0, 0], [0, 0, 0, 0], [8, 32, 0, 0], [2, 128, 0, 2]]",804,right,0,"[[0, 0, 0, 4], [0, 0, 0, 2], [0, 0, 8, 32], [0, 2, 128, 2]]",804
13,"[[0, 0, 0, 4], [0, 0, 0, 2], [0, 0, 8, 32], [0, 2, 128, 2]]",804,down,0,"[[0, 0, 0, 4], [0, 4, 0, 2], [0, 0, 8, 32], [0, 2, 128, 2]]",804
13,"[[0, 0, 0, 4], [0, 4, 0, 2], [0, 0, 8, 32], [0, 2, 128, 2]]",804,left,0,"[[4, 0, 0, 0], [4, 2, 0, 4], [8, 32, 0, 0], [2, 128, 2, 0]]",804
13,"[[4, 0, 0, 0], [4, 2, 0, 4], [8, 32, 0, 0], [2, 128, 2, 0]]",804,up,8,"[[8, 2, 2, 4], [8, 32, 0, 0], [2, 128, 0, 0], [0, 0, 2, 0]]",812
13,"[[8, 2, 2, 4], [8, 32, 0, 0], [2, 128, 0, 0], [0, 0, 2, 0]]",812,up,20,"[[16, 2, 4, 4], [2, 32, 0, 0], [2, 128, 0, 0], [0, 0, 0, 0]]",832
13,"[[16, 2, 4, 4], [2, 32, 0, 0], [2, 128, 0, 0], [0, 0, 0, 0]]",832,up,4,"[[16, 2, 4, 4], [4, 32, 0, 0], [0, 128, 4, 0], [0, 0, 0, 0]]",836
13,"[[16, 2, 4, 4], [4, 32, 0, 0], [0, 128, 4, 0], [0, 0, 0, 0]]",836,up,8,"[[16, 2, 8, 4], [4, 32, 4, 0], [0, 128, 0, 0], [0, 0, 0, 0]]",844
13,"[[16, 2, 8, 4], [4, 32, 4, 0], [0, 128, 0, 0], [0, 0, 0, 0]]",844,down,0,"[[0, 0, 0, 2], [0, 2, 0, 0], [16, 32, 8, 0], [4, 128, 4, 4]]",844
13,"[[0, 0, 0, 2], [0, 2, 0, 0], [16, 32, 8, 0], [4, 128, 4, 4]]",844,right,8,"[[0, 0, 0, 2], [0, 0, 0, 2], [2, 16, 32, 8], [0, 4, 128, 8]]",852
13,"[[0, 0, 0, 2], [0, 0, 0, 2], [2, 16, 32, 8], [0, 4, 128, 8]]",852,down,20,"[[0, 4, 0, 0], [0, 0, 0, 0], [0, 16, 32, 4], [2, 4, 128, 16]]",872
13,"[[0, 4, 0, 0], [0, 0, 0, 0], [0, 16, 32, 4], [2, 4, 128, 16]]",872,right,0,"[[0, 0, 0, 4], [0, 4, 0, 0], [0, 16, 32, 4], [2, 4, 128, 16]]",872
13,"[[0, 0, 0, 4], [0, 4, 0, 0], [0, 16, 32, 4], [2, 4, 128, 16]]",872,down,8,"[[2, 0, 0, 0], [0, 4, 0, 0], [0, 16, 32, 8], [2, 4, 128, 16]]",880
13,"[[2, 0, 0, 0], [0, 4, 0, 0], [0, 16, 32, 8], [2, 4, 128, 16]]",880,left,0,"[[2, 0, 0, 0], [4, 0, 4, 0], [16, 32, 8, 0], [2, 4, 128, 16]]",880
13,"[[2, 0, 0, 0], [4, 0, 4, 0], [16, 32, 8, 0], [2, 4, 128, 16]]",880,right,8,"[[0, 0, 0, 2], [0, 0, 4, 8], [0, 16, 32, 8], [2, 4, 128, 16]]",888
13,"[[0, 0, 0, 2], [0, 0, 4, 8], [0, 16, 32, 8], [2, 4, 128, 16]]",888,up,16,"[[2, 16, 4, 2], [0, 4, 32, 16], [0, 0, 128, 16], [0, 0, 4, 0]]",904
13,"[[2, 16, 4, 2], [0, 4, 32, 16], [0, 0, 128, 16], [0, 0, 4, 0]]",904,up,32,"[[2, 16, 4, 2], [0, 4, 32, 32], [0, 0, 128, 0], [0, 0, 4, 2]]",936
13,"[[2, 16, 4, 2], [0, 4, 32, 32], [0, 0, 128, 0], [0, 0, 4, 2]]",936,right,64,"[[2, 16, 4, 2], [0, 2, 4, 64], [0, 0, 0, 128], [0, 0, 4, 2]]",1000
13,"[[2, 16, 4, 2], [0, 2, 4, 64], [0, 0, 0, 128], [0, 0, 4, 2]]",1000,up,8,"[[2, 16, 8, 2], [0, 2, 4, 64], [0, 0, 0, 128], [4, 0, 0, 2]]",1008
13,"[[2, 16, 8, 2], [0, 2, 4, 64], [0, 0, 0, 128], [4, 0, 0, 2]]",1008,right,0,"[[2, 16, 8, 2], [0, 2, 4, 64], [0, 4, 0, 128], [0, 0, 4, 2]]",1008
13,"[[2, 16, 8, 2], [0, 2, 4, 64], [0, 4, 0, 128], [0, 0, 4, 2]]",1008,up,8,"[[2, 16, 8, 2], [0, 2, 8, 64], [0, 4, 0, 128], [0, 2, 0, 2]]",1016
13,"[[2, 16, 8, 2], [0, 2, 8, 64], [0, 4, 0, 128], [0, 2, 0, 2]]",1016,up,16,"[[2, 16, 16, 2], [0, 2, 0, 64], [0, 4, 0, 128], [0, 2, 2, 2]]",1032
13,"[[2, 16, 16, 2], [0, 2, 0, 64], [0, 4, 0, 128], [0, 2, 2, 2]]",1032,left,36,"[[2, 32, 2, 0], [2, 64, 0, 0], [4, 128, 0, 0], [4, 2, 2, 0]]",1068
13,"[[2, 32, 2, 0], [2, 64, 0, 0], [4, 128, 0, 0], [4, 2, 2, 0]]",1068,up,16,"[[4, 32, 4, 0], [8, 64, 0, 0], [2, 128, 0, 0], [0, 2, 0, 0]]",1084
13,"[[4, 32, 4, 0], [8, 64, 0, 0], [2, 128, 0, 0], [0, 2, 0, 0]]",1084,down,0,"[[2, 32, 0, 0], [4, 64, 0, 0], [8, 128, 0, 0], [2, 2, 4, 0]]",1084
13,"[[2, 32, 0, 0], [4, 64, 0, 0], [8, 128, 0, 0], [2, 2, 4, 0]]",1084,left,4,"[[2, 32, 0, 0], [4, 64, 4, 0], [8, 128, 0, 0], [4, 4, 0, 0]]",1088
13,"[[2, 32, 0, 0], [4, 64, 4, 0], [8, 128, 0, 0], [4, 4, 0, 0]]",1088,left,8,"[[2, 32, 0, 0], [4, 64, 4, 0], [8, 128, 0, 0], [8, 4, 0, 0]]",1096
13,"[[2, 32, 0, 0], [4, 64, 4, 0], [8, 128, 0, 0], [8, 4, 0, 0]]",1096,down,16,"[[0, 32, 0, 0], [2, 64, 0, 0], [4, 128, 0, 2], [16, 4, 4, 0]]",1112
13,"[[0, 32, 0, 0], [2, 64, 0, 0], [4, 128, 0, 2], [16, 4, 4, 0]]",1112,right,8,"[[0, 2, 0, 32], [0, 0, 2, 64], [0, 4, 128, 2], [0, 0, 16, 8]]",1120
13,"[[0, 2, 0, 32], [0, 0, 2, 64], [0, 4, 128, 2], [0, 0, 16, 8]]",1120,left,0,"[[2, 32, 0, 0], [2, 64, 4, 0], [4, 128, 2, 0], [16, 8, 0, 0]]",1120
13,"[[2, 32, 0, 0], [2, 64, 4, 0], [4, 128, 2, 0], [16, 8, 0, 0]]",1120,down,4,"[[0, 32, 0, 0], [4, 64, 0, 0], [4, 128, 4, 2], [16, 8, 2, 0]]",1124
13,"[[0, 32, 0, 0], [4, 64, 0, 0], [4, 128, 4, 2], [16, 8, 2, 0]]",1124,down,8,"[[0, 32, 4, 0], [0, 64, 0, 0], [8, 128, 4, 0], [16, 8, 2, 2]]",1132
13,"[[0, 32, 4, 0], [0, 64, 0, 0], [8, 128, 4, 0], [16, 8, 2, 2]]",1132,left,4,"[[32, 4, 0, 0], [64, 4, 0, 0], [8, 128, 4, 0], [16, 8, 4, 0]]",1136
13,"[[32, 4, 0, 0], [64, 4, 0, 0], [8, 128, 4, 0], [16, 8, 4, 0]]",1136,up,16,"[[32, 8, 8, 0], [64, 128, 2, 0], [8, 8, 0, 0], [16, 0, 0, 0]]",1152
13,"[[32, 8, 8, 0], [64, 128, 2, 0], [8, 8, 0, 0], [16, 0, 0, 0]]",1152,left,32,"[[32, 16, 0, 0], [64, 128, 2, 0], [16, 0, 0, 0], [16, 4, 0, 0]]",1184
13,"[[32, 16, 0, 0], [64, 128, 2, 0], [16, 0, 0, 0], [16, 4, 0, 0]]",1184,up,32,"[[32, 16, 2, 0], [64, 128, 0, 0], [32, 4, 0, 4], [0, 0, 0, 0]]",1216
13,"[[32, 16, 2, 0], [64, 128, 0, 0], [32, 4, 0, 4], [0, 0, 0, 0]]",1216,right,8,"[[0, 32, 16, 2], [2, 0, 64, 128], [0, 0, 32, 8], [0, 0, 0, 0]]",1224
13,"[[0, 32, 16, 2], [2, 0, 64, 128], [0, 0, 32, 8], [0, 0, 0, 0]]",1224,down,0,"[[0, 0, 0, 0], [0, 2, 16, 2], [0, 0, 64, 128], [2, 32, 32, 8]]",1224
13,"[[0, 0, 0, 0], [0, 2, 16, 2], [0, 0, 64, 128], [2, 32, 32, 8]]",1224,right,64,"[[0, 0, 0, 0], [4, 2, 16, 2], [0, 0, 64, 128], [0, 2, 64, 8]]",1288
13,"[[0, 0, 0, 0], [4, 2, 16, 2], [0, 0, 64, 128], [0, 2, 64, 8]]",1288,up,132,"[[4, 4, 16, 2], [0, 0, 128, 128], [0, 2, 0, 8], [0, 0, 0, 0]]",1420
13,"[[4, 4, 16, 2], [0, 0, 128, 128], [0, 2, 0, 8], [0, 0, 0, 0]]",1420,right,264,"[[0, 8, 16, 2], [0, 0, 0, 256], [0, 0, 2, 8], [0, 0, 2, 0]]",1684
13,"[[0, 8, 16, 2], [0, 0, 0, 256], [0, 0, 2, 8], [0, 0, 2, 0]]",1684,up,4,"[[0, 8, 16, 2], [0, 0, 4, 256], [0, 0, 0, 8], [2, 0, 0, 0]]",1688
13,"[[0, 8, 16, 2], [0, 0, 4, 256], [0, 0, 0, 8], [2, 0, 0, 0]]",1688,right,0,"[[2, 8, 16, 2], [0, 0, 4, 256], [0, 0, 0, 8], [0, 0, 0, 2]]",1688
13,"[[2, 8, 16, 2], [0, 0, 4, 256], [0, 0, 0, 8], [0, 0, 0, 2]]",1688,up,0,"[[2, 8, 16, 2], [0, 0, 4, 256], [0, 0, 0, 8], [0, 0, 2, 2]]",1688
13,"[[2, 8, 16, 2], [0, 0, 4, 256], [0, 0, 0, 8], [0, 0, 2, 2]]",1688,right,4,"[[2, 8, 16, 2], [0, 0, 4, 256], [0, 0, 0, 8], [0, 0, 2, 4]]",1692
13,"[[2, 8, 16, 2], [0, 0, 4, 256], [0, 0, 0, 8], [0, 0, 2, 4]]",1692,down,0,"[[0, 2, 0, 2], [0, 0, 16, 256], [0, 0, 4, 8], [2, 8, 2, 4]]",1692
13,"[[0, 2, 0, 2], [0, 0, 16, 256], [0, 0, 4, 8], [2, 8, 2, 4]]",1692,left,4,"[[4, 0, 0, 2], [16, 256, 0, 0], [4, 8, 0, 0], [2, 8, 2, 4]]",1696
13,"[[4, 0, 0, 2], [16, 256, 0, 0], [4, 8, 0, 0], [2, 8, 2, 4]]",1696,up,16,"[[4, 256, 2, 2], [16, 16, 2, 4], [4, 0, 0, 0], [2, 0, 0, 0]]",1712
13,"[[4, 256, 2, 2], [16, 16, 2, 4], [4, 0, 0, 0], [2, 0, 0, 0]]",1712,left,36,"[[4, 256, 4, 0], [32, 2, 4, 0], [4, 0, 0, 0], [2, 0, 0, 4]]",1748
13,"[[4, 256, 4, 0], [32, 2, 4, 0], [4, 0, 0, 0], [2, 0, 0, 4]]",1748,down,8,"[[4, 0, 0, 0], [32, 0, 0, 0], [4, 256, 4, 0], [2, 2, 8, 4]]",1756
13,"[[4, 0, 0, 0], [32, 0, 0, 0], [4, 256, 4, 0], [2, 2, 8, 4]]",1756,right,4,"[[0, 0, 0, 4], [0, 0, 2, 32], [0, 4, 256, 4], [0, 4, 8, 4]]",1760
13,"[[0, 0, 0, 4], [0, 0, 2, 32], [0, 4, 256, 4], [0, 4, 8, 4]]",1760,down,16,"[[0, 0, 0, 0], [2, 0, 2, 4], [0, 0, 256, 32], [0, 8, 8, 8]]",1776
13,"[[0, 0, 0, 0], [2, 0, 2, 4], [0, 0, 256, 32], [0, 8, 8, 8]]",1776,right,20,"[[0, 0, 2, 0], [0, 0, 4, 4], [0, 0, 256, 32], [0, 0, 8, 16]]",1796
13,"[[0, 0, 2, 0], [0, 0, 4, 4], [0, 0, 256, 32], [0, 0, 8, 16]]",1796,right,8,"[[0, 0, 0, 2], [0, 0, 0, 8], [0, 0, 256, 32], [0, 2, 8, 16]]",1804
13,"[[0, 0, 0, 2], [0, 0, 0, 8], [0, 0, 256, 32], [0, 2, 8, 16]]",1804,up,0,"[[0, 2, 256, 2], [0, 2, 8, 8], [0, 0, 0, 32], [0, 0, 0, 16]]",1804
13,"[[0, 2, 256, 2], [0, 2, 8, 8], [0, 0, 0, 32], [0, 0, 0, 16]]",1804,left,16,"[[2, 256, 2, 0], [2, 16, 0, 0], [32, 0, 2, 0], [16, 0, 0, 0]]",1820
13,"[[2, 256, 2, 0], [2, 16, 0, 0], [32, 0, 2, 0], [16, 0, 0, 0]]",1820,down,8,"[[0, 4, 0, 0], [4, 0, 0, 0], [32, 256, 0, 0], [16, 16, 4, 0]]",1828
13,"[[0, 4, 0, 0], [4, 0, 0, 0], [32, 256, 0, 0], [16, 16, 4, 0]]",1828,left,32,"[[4, 0, 0, 0], [4, 0, 0, 4], [32, 256, 0, 0], [32, 4, 0, 0]]",1860
13,"[[4, 0, 0, 0], [4, 0, 0, 4], [32, 256, 0, 0], [32, 4, 0, 0]]",1860,down,72,"[[0, 0, 0, 0], [0, 0, 2, 0], [8, 256, 0, 0], [64, 4, 0, 4]]",1932
13,"[[0, 0, 0, 0], [0, 0, 2, 0], [8, 256, 0, 0], [64, 4, 0, 4]]",1932,left,8,"[[0, 0, 0, 0], [2, 4, 0, 0], [8, 256, 0, 0], [64, 8, 0, 0]]",1940
13,"[[0, 0, 0, 0], [2, 4, 0, 0], [8, 256, 0, 0], [64, 8, 0, 0]]",1940,left,0,"[[0, 0, 0, 0], [2, 4, 0, 0], [8, 256, 0, 2], [64, 8, 0, 0]]",1940
13,"[[0, 0, 0, 0], [2, 4, 0, 0], [8, 256, 0, 2], [64, 8, 0, 0]]",1940,left,0,"[[0, 0, 0, 0], [2, 4, 0, 0], [8, 256, 2, 4], [64, 8, 0, 0]]",1940
13,"[[0, 0, 0, 0], [2, 4, 0, 0], [8, 256, 2, 4], [64, 8, 0, 0]]",1940,right,0,"[[0, 0, 0, 0], [2, 0, 2, 4], [8, 256, 2, 4], [0, 0, 64, 8]]",1940
13,"[[0, 0, 0, 0], [2, 0, 2, 4], [8, 256, 2, 4], [0, 0, 64, 8]]",1940,down,12,"[[0, 0, 0, 0], [4, 0, 0, 0], [2, 0, 4, 8], [8, 256, 64, 8]]",1952
13,"[[0, 0, 0, 0], [4, 0, 0, 0], [2, 0, 4, 8], [8, 256, 64, 8]]",1952,down,16,"[[4, 0, 0, 0], [4, 0, 0, 0], [2, 0, 4, 0], [8, 256, 64, 16]]",1968
13,"[[4, 0, 0, 0], [4, 0, 0, 0], [2, 0, 4, 0], [8, 256, 64, 16]]",1968,right,0,"[[0, 2, 0, 4], [0, 0, 0, 4], [0, 0, 2, 4], [8, 256, 64, 16]]",1968
13,"[[0, 2, 0, 4], [0, 0, 0, 4], [0, 0, 2, 4], [8, 256, 64, 16]]",1968,down,8,"[[0, 0, 2, 0], [0, 0, 0, 4], [0, 2, 2, 8], [8, 256, 64, 16]]",1976
13,"[[0, 0, 2, 0], [0, 0, 0, 4], [0, 2, 2, 8], [8, 256, 64, 16]]",1976,left,4,"[[2, 0, 2, 0], [4, 0, 0, 0], [4, 8, 0, 0], [8, 256, 64, 16]]",1980
13,"[[2, 0, 2, 0], [4, 0, 0, 0], [4, 8, 0, 0], [8, 256, 64, 16]]",1980,right,4,"[[0, 0, 4, 4], [0, 0, 0, 4], [0, 0, 4, 8], [8, 256, 64, 16]]",1984
13,"[[0, 0, 4, 4], [0, 0, 0, 4], [0, 0, 4, 8], [8, 256, 64, 16]]",1984,down,16,"[[0, 0, 0, 0], [0, 0, 0, 8], [0, 4, 8, 8], [8, 256, 64, 16]]",2000
13,"[[0, 0, 0, 0], [0, 0, 0, 8], [0, 4, 8, 8], [8, 256, 64, 16]]",2000,down,16,"[[4, 0, 0, 0], [0, 0, 0, 0], [0, 4, 8, 16], [8, 256, 64, 16]]",2016
13,"[[4, 0, 0, 0], [0, 0, 0, 0], [0, 4, 8, 16], [8, 256, 64, 16]]",2016,down,32,"[[2, 0, 0, 0], [0, 0, 0, 0], [4, 4, 8, 0], [8, 256, 64, 32]]",2048
13,"[[2, 0, 0, 0], [0, 0, 0, 0], [4, 4, 8, 0], [8, 256, 64, 32]]",2048,left,8,"[[2, 0, 0, 0], [0, 0, 0, 0], [8, 8, 2, 0], [8, 256, 64, 32]]",2056
13,"[[2, 0, 0, 0], [0, 0, 0, 0], [8, 8, 2, 0], [8, 256, 64, 32]]",2056,down,16,"[[0, 0, 0, 0], [0, 0, 0, 2], [2, 8, 2, 0], [16, 256, 64, 32]]",2072
13,"[[0, 0, 0, 0], [0, 0, 0, 2], [2, 8, 2, 0], [16, 256, 64, 32]]",2072,down,0,"[[0, 2, 0, 0], [0, 0, 0, 0], [2, 8, 2, 2], [16, 256, 64, 32]]",2072
13,"[[0, 2, 0, 0], [0, 0, 0, 0], [2, 8, 2, 2], [16, 256, 64, 32]]",2072,left,4,"[[2, 0, 0, 0], [0, 0, 0, 4], [2, 8, 4, 0], [16, 256, 64, 32]]",2076
13,"[[2, 0, 0, 0], [0, 0, 0, 4], [2, 8, 4, 0], [16, 256, 64, 32]]",2076,down,4,"[[0, 0, 0, 0], [0, 0, 2, 0], [4, 8, 4, 4], [16, 256, 64, 32]]",2080
13,"[[0, 0, 0, 0], [0, 0, 2, 0], [4, 8, 4, 4], [16, 256, 64, 32]]",2080,right,8,"[[0, 0, 4, 0], [0, 0, 0, 2], [0, 4, 8, 8], [16, 256, 64, 32]]",2088
13,"[[0, 0, 4, 0], [0, 0, 0, 2], [0, 4, 8, 8], [16, 256, 64, 32]]",2088,right,16,"[[0, 0, 0, 4], [0, 0, 4, 2], [0, 0, 4, 16], [16, 256, 64, 32]]",2104
13,"[[0, 0, 0, 4], [0, 0, 4, 2], [0, 0, 4, 16], [16, 256, 64, 32]]",2104,down,8,"[[0, 0, 0, 4], [4, 0, 0, 2], [0, 0, 8, 16], [16, 256, 64, 32]]",2112
13,"[[0, 0, 0, 4], [4, 0, 0, 2], [0, 0, 8, 16], [16, 256, 64, 32]]",2112,left,0,"[[4, 0, 0, 4], [4, 2, 0, 0], [8, 16, 0, 0], [16, 256, 64, 32]]",2112
13,"[[4, 0, 0, 4], [4, 2, 0, 0], [8, 16, 0, 0], [16, 256, 64, 32]]",2112,down,8,"[[2, 0, 0, 0], [8, 2, 0, 0], [8, 16, 0, 4], [16, 256, 64, 32]]",2120
13,"[[2, 0, 0, 0], [8, 2, 0, 0], [8, 16, 0, 4], [16, 256, 64, 32]]",2120,up,16,"[[2, 2, 64, 4], [16, 16, 0, 32], [16, 256, 0, 0], [2, 0, 0, 0]]",2136
13,"[[2, 2, 64, 4], [16, 16, 0, 32], [16, 256, 0, 0], [2, 0, 0, 0]]",2136,right,36,"[[0, 4, 64, 4], [0, 4, 32, 32], [0, 0, 16, 256], [0, 0, 0, 2]]",2172
13,"[[0, 4, 64, 4], [0, 4, 32, 32], [0, 0, 16, 256], [0, 0, 0, 2]]",2172,left,64,"[[4, 64, 4, 2], [4, 64, 0, 0], [16, 256, 0, 0], [2, 0, 0, 0]]",2236
13,"[[4, 64, 4, 2], [4, 64, 0, 0], [16, 256, 0, 0], [2, 0, 0, 0]]",2236,down,136,"[[0, 0, 2, 0], [8, 0, 0, 0], [16, 128, 0, 0], [2, 256, 4, 2]]",2372
13,"[[0, 0, 2, 0], [8, 0, 0, 0], [16, 128, 0, 0], [2, 256, 4, 2]]",2372,up,0,"[[8, 128, 2, 2], [16, 256, 4, 2], [2, 0, 0, 0], [0, 0, 0, 0]]",2372
13,"[[8, 128, 2, 2], [16, 256, 4, 2], [2, 0, 0, 0], [0, 0, 0, 0]]",2372,right,4,"[[0, 8, 128, 4], [16, 256, 4, 2], [0, 0, 0, 2], [2, 0, 0, 0]]",2376
13,"[[0, 8, 128, 4], [16, 256, 4, 2], [0, 0, 0, 2], [2, 0, 0, 0]]",2376,up,4,"[[16, 8, 128, 4], [2, 256, 4, 4], [0, 0, 0, 0], [0, 0, 4, 0]]",2380
13,"[[16, 8, 128, 4], [2, 256, 4, 4], [0, 0, 0, 0], [0, 0, 4, 0]]",2380,down,16,"[[0, 0, 2, 0], [0, 0, 0, 0], [16, 8, 128, 0], [2, 256, 8, 8]]",2396
13,"[[0, 0, 2, 0], [0, 0, 0, 0], [16, 8, 128, 0], [2, 256, 8, 8]]",2396,left,16,"[[2, 0, 0, 0], [4, 0, 0, 0], [16, 8, 128, 0], [2, 256, 16, 0]]",2412
13,"[[2, 0, 0, 0], [4, 0, 0, 0], [16, 8, 128, 0], [2, 256, 16, 0]]",2412,down,0,"[[2, 0, 0, 0], [4, 2, 0, 0], [16, 8, 128, 0], [2, 256, 16, 0]]",2412
13,"[[2, 0, 0, 0], [4, 2, 0, 0], [16, 8, 128, 0], [2, 256, 16, 0]]",2412,right,0,"[[0, 0, 0, 2], [0, 4, 4, 2], [0, 16, 8, 128], [0, 2, 256, 16]]",2412
13,"[[0, 0, 0, 2], [0, 4, 4, 2], [0, 16, 8, 128], [0, 2, 256, 16]]",2412,right,8,"[[0, 0, 0, 2], [0, 2, 8, 2], [0, 16, 8, 128], [0, 2, 256, 16]]",2420
13,"[[0, 0, 0, 2], [0, 2, 8, 2], [0, 16, 8, 128], [0, 2, 256, 16]]",2420,down,20,"[[0, 4, 0, 0], [0, 2, 0, 4], [0, 16, 16, 128], [0, 2, 256, 16]]",2440
13,"[[0, 4, 0, 0], [0, 2, 0, 4], [0, 16, 16, 128], [0, 2, 256, 16]]",2440,right,32,"[[2, 0, 0, 4], [0, 0, 2, 4], [0, 0, 32, 128], [0, 2, 256, 16]]",2472
13,"[[2, 0, 0, 4], [0, 0, 2, 4], [0, 0, 32, 128], [0, 2, 256, 16]]",2472,down,8,"[[0, 0, 0, 2], [0, 0, 2, 8], [0, 0, 32, 128], [2, 2, 256, 16]]",2480
13,"[[0, 0, 0, 2], [0, 0, 2, 8], [0, 0, 32, 128], [2, 2, 256, 16]]",2480,up,0,"[[2, 2, 2, 2], [0, 0, 32, 8], [0, 0, 256, 128], [2, 0, 0, 16]]",2480
13,"[[2, 2, 2, 2], [0, 0, 32, 8], [0, 0, 256, 128], [2, 0, 0, 16]]",2480,right,8,"[[0, 0, 4, 4], [0, 0, 32, 8], [0, 2, 256, 128], [0, 0, 2, 16]]",2488
13,"[[0, 0, 4, 4], [0, 0, 32, 8], [0, 2, 256, 128], [0, 0, 2, 16]]",2488,right,8,"[[0, 0, 2, 8], [0, 0, 32, 8], [0, 2, 256, 128], [0, 0, 2, 16]]",2496
13,"[[0, 0, 2, 8], [0, 0, 32, 8], [0, 2, 256, 128], [0, 0, 2, 16]]",2496,up,16,"[[0, 2, 2, 16], [0, 4, 32, 128], [0, 0, 256, 16], [0, 0, 2, 0]]",2512
13,"[[0, 2, 2, 16], [0, 4, 32, 128], [0, 0, 256, 16], [0, 0, 2, 0]]",2512,right,4,"[[0, 0, 4, 16], [0, 4, 32, 128], [0, 0, 256, 16], [2, 0, 0, 2]]",2516
13,"[[0, 0, 4, 16], [0, 4, 32, 128], [0, 0, 256, 16], [2, 0, 0, 2]]",2516,right,4,"[[0, 0, 4, 16], [0, 4, 32, 128], [0, 4, 256, 16], [0, 0, 0, 4]]",2520
13,"[[0, 0, 4, 16], [0, 4, 32, 128], [0, 4, 256, 16], [0, 0, 0, 4]]",2520,left,0,"[[4, 16, 0, 0], [4, 32, 128, 4], [4, 256, 16, 0], [4, 0, 0, 0]]",2520
13,"[[4, 16, 0, 0], [4, 32, 128, 4], [4, 256, 16, 0], [4, 0, 0, 0]]",2520,up,16,"[[8, 16, 128, 4], [8, 32, 16, 0], [0, 256, 0, 0], [2, 0, 0, 0]]",2536
13,"[[8, 16, 128, 4], [8, 32, 16, 0], [0, 256, 0, 0], [2, 0, 0, 0]]",2536,up,16,"[[16, 16, 128, 4], [2, 32, 16, 2], [0, 256, 0, 0], [0, 0, 0, 0]]",2552
13,"[[16, 16, 128, 4], [2, 32, 16, 2], [0, 256, 0, 0], [0, 0, 0, 0]]",2552,right,32,"[[0, 32, 128, 4], [2, 32, 16, 2], [0, 0, 0, 256], [0, 0, 0, 4]]",2584
13,"[[0, 32, 128, 4], [2, 32, 16, 2], [0, 0, 0, 256], [0, 0, 0, 4]]",2584,down,64,"[[0, 0, 0, 4], [0, 0, 0, 2], [2, 0, 128, 256], [2, 64, 16, 4]]",2648
13,"[[0, 0, 0, 4], [0, 0, 0, 2], [2, 0, 128, 256], [2, 64, 16, 4]]",2648,down,4,"[[0, 0, 0, 4], [0, 2, 0, 2], [0, 0, 128, 256], [4, 64, 16, 4]]",2652
13,"[[0, 0, 0, 4], [0, 2, 0, 2], [0, 0, 128, 256], [4, 64, 16, 4]]",2652,right,4,"[[0, 0, 0, 4], [4, 0, 0, 4], [0, 0, 128, 256], [4, 64, 16, 4]]",2656
13,"[[0, 0, 0, 4], [4, 0, 0, 4], [0, 0, 128, 256], [4, 64, 16, 4]]",2656,up,16,"[[8, 64, 128, 8], [0, 0, 16, 256], [0, 0, 0, 4], [0, 2, 0, 0]]",2672
13,"[[8, 64, 128, 8], [0, 0, 16, 256], [0, 0, 0, 4], [0, 2, 0, 0]]",2672,right,0,"[[8, 64, 128, 8], [0, 0, 16, 256], [0, 0, 0, 4], [0, 2, 0, 2]]",2672
13,"[[8, 64, 128, 8], [0, 0, 16, 256], [0, 0, 0, 4], [0, 2, 0, 2]]",2672,right,4,"[[8, 64, 128, 8], [0, 2, 16, 256], [0, 0, 0, 4], [0, 0, 0, 4]]",2676
13,"[[8, 64, 128, 8], [0, 2, 16, 256], [0, 0, 0, 4], [0, 0, 0, 4]]",2676,right,0,"[[8, 64, 128, 8], [2, 2, 16, 256], [0, 0, 0, 4], [0, 0, 0, 4]]",2676
13,"[[8, 64, 128, 8], [2, 2, 16, 256], [0, 0, 0, 4], [0, 0, 0, 4]]",2676,left,4,"[[8, 64, 128, 8], [4, 16, 256, 0], [4, 0, 0, 0], [4, 4, 0, 0]]",2680
13,"[[8, 64, 128, 8], [4, 16, 256, 0], [4, 0, 0, 0], [4, 4, 0, 0]]",2680,up,8,"[[8, 64, 128, 8], [8, 16, 256, 0], [4, 4, 0, 0], [0, 0, 0, 4]]",2688
13,"[[8, 64, 128, 8], [8, 16, 256, 0], [4, 4, 0, 0], [0, 0, 0, 4]]",2688,down,16,"[[2, 0, 0, 0], [0, 64, 0, 0], [16, 16, 128, 8], [4, 4, 256, 4]]",2704
13,"[[2, 0, 0, 0], [0, 64, 0, 0], [16, 16, 128, 8], [4, 4, 256, 4]]",2704,left,40,"[[2, 0, 0, 0], [64, 4, 0, 0], [32, 128, 8, 0], [8, 256, 4, 0]]",2744
13,"[[2, 0, 0, 0], [64, 4, 0, 0], [32, 128, 8, 0], [8, 256, 4, 0]]",2744,left,0,"[[2, 0, 0, 2], [64, 4, 0, 0], [32, 128, 8, 0], [8, 256, 4, 0]]",2744
13,"[[2, 0, 0, 2], [64, 4, 0, 0], [32, 128, 8, 0], [8, 256, 4, 0]]",2744,right,4,"[[0, 0, 0, 4], [2, 0, 64, 4], [0, 32, 128, 8], [0, 8, 256, 4]]",2748
13,"[[0, 0, 0, 4], [2, 0, 64, 4], [0, 32, 128, 8], [0, 8, 256, 4]]",2748,up,8,"[[2, 32, 64, 8], [4, 8, 128, 8], [0, 0, 256, 4], [0, 0, 0, 0]]",2756
13,"[[2, 32, 64, 8], [4, 8, 128, 8], [0, 0, 256, 4], [0, 0, 0, 0]]",2756,up,16,"[[2, 32, 64, 16], [4, 8, 128, 4], [0, 0, 256, 0], [4, 0, 0, 0]]",2772
13,"[[2, 32, 64, 16], [4, 8, 128, 4], [0, 0, 256, 0], [4, 0, 0, 0]]",2772,up,8,"[[2, 32, 64, 16], [8, 8, 128, 4], [0, 2, 256, 0], [0, 0, 0, 0]]",2780
13,"[[2, 32, 64, 16], [8, 8, 128, 4], [0, 2, 256, 0], [0, 0, 0, 0]]",2780,left,16,"[[2, 32, 64, 16], [16, 128, 4, 0], [2, 256, 0, 2], [0, 0, 0, 0]]",2796
13,"[[2, 32, 64, 16], [16, 128, 4, 0], [2, 256, 0, 2], [0, 0, 0, 0]]",2796,up,0,"[[2, 32, 64, 16], [16, 128, 4, 2], [2, 256, 2, 0], [0, 0, 0, 0]]",2796
13,"[[2, 32, 64, 16], [16, 128, 4, 2], [2, 256, 2, 0], [0, 0, 0, 0]]",2796,left,0,"[[2, 32, 64, 16], [16, 128, 4, 2], [2, 256, 2, 0], [0, 0, 4, 0]]",2796
13,"[[2, 32, 64, 16], [16, 128, 4, 2], [2, 256, 2, 0], [0, 0, 4, 0]]",2796,right,0,"[[2, 32, 64, 16], [16, 128, 4, 2], [4, 2, 256, 2], [0, 0, 0, 4]]",2796
13,"[[2, 32, 64, 16], [16, 128, 4, 2], [4, 2, 256, 2], [0, 0, 0, 4]]",2796,up,4,"[[2, 32, 64, 16], [16, 128, 4, 4], [4, 2, 256, 4], [0, 0, 2, 0]]",2800
13,"[[2, 32, 64, 16], [16, 128, 4, 4], [4, 2, 256, 4], [0, 0, 2, 0]]",2800,right,8,"[[2, 32, 64, 16], [0, 16, 128, 8], [4, 2, 256, 4], [0, 0, 2, 2]]",2808
13,"[[2, 32, 64, 16], [0, 16, 128, 8], [4, 2, 256, 4], [0, 0, 2, 2]]",2808,right,4,"[[2, 32, 64, 16], [0, 16, 128, 8], [4, 2, 256, 4], [4, 0, 0, 4]]",2812
13,"[[2, 32, 64, 16], [0, 16, 128, 8], [4, 2, 256, 4], [4, 0, 0, 4]]",2812,down,16,"[[2, 0, 0, 0], [0, 32, 64, 16], [2, 16, 128, 8], [8, 2, 256, 8]]",2828
13,"[[2, 0, 0, 0], [0, 32, 64, 16], [2, 16, 128, 8], [8, 2, 256, 8]]",2828,down,20,"[[0, 0, 0, 4], [0, 32, 64, 0], [4, 16, 128, 16], [8, 2, 256, 16]]",2848
13,"[[0, 0, 0, 4], [0, 32, 64, 0], [4, 16, 128, 16], [8, 2, 256, 16]]",2848,up,32,"[[4, 32, 64, 4], [8, 16, 128, 32], [0, 2, 256, 0], [0, 0, 0, 2]]",2880
13,"[[4, 32, 64, 4], [8, 16, 128, 32], [0, 2, 256, 0], [0, 0, 0, 2]]",2880,right,0,"[[4, 32, 64, 4], [8, 16, 128, 32], [0, 0, 2, 256], [0, 0, 4, 2]]",2880
13,"[[4, 32, 64, 4], [8, 16, 128, 32], [0, 0, 2, 256], [0, 0, 4, 2]]",2880,down,0,"[[0, 0, 64, 4], [4, 0, 128, 32], [4, 32, 2, 256], [8, 16, 4, 2]]",2880
13,"[[0, 0, 64, 4], [4, 0, 128, 32], [4, 32, 2, 256], [8, 16, 4, 2]]",2880,down,8,"[[2, 0, 64, 4], [0, 0, 128, 32], [8, 32, 2, 256], [8, 16, 4, 2]]",2888
13,"[[2, 0, 64, 4], [0, 0, 128, 32], [8, 32, 2, 256], [8, 16, 4, 2]]",2888,left,0,"[[2, 64, 4, 4], [128, 32, 0, 0], [8, 32, 2, 256], [8, 16, 4, 2]]",2888
13,"[[2, 64, 4, 4], [128, 32, 0, 0], [8, 32, 2, 256], [8, 16, 4, 2]]",2888,down,80,"[[0, 4, 0, 0], [2, 64, 4, 4], [128, 64, 2, 256], [16, 16, 4, 2]]",2968
13,"[[0, 4, 0, 0], [2, 64, 4, 4], [128, 64, 2, 256], [16, 16, 4, 2]]",2968,down,128,"[[4, 0, 0, 0], [2, 4, 4, 4], [128, 128, 2, 256], [16, 16, 4, 2]]",3096
13,"[[4, 0, 0, 0], [2, 4, 4, 4], [128, 128, 2, 256], [16, 16, 4, 2]]",3096,left,296,"[[4, 0, 0, 2], [2, 8, 4, 0], [256, 2, 256, 0], [32, 4, 2, 0]]",3392
13,"[[4, 0, 0, 2], [2, 8, 4, 0], [256, 2, 256, 0], [32, 4, 2, 0]]",3392,up,0,"[[4, 8, 4, 2], [2, 2, 256, 0], [256, 4, 2, 2], [32, 0, 0, 0]]",3392
13,"[[4, 8, 4, 2], [2, 2, 256, 0], [256, 4, 2, 2], [32, 0, 0, 0]]",3392,left,8,"[[4, 8, 4, 2], [4, 256, 0, 2], [256, 4, 4, 0], [32, 0, 0, 0]]",3400
13,"[[4, 8, 4, 2], [4, 256, 0, 2], [256, 4, 4, 0], [32, 0, 0, 0]]",3400,down,20,"[[0, 0, 0, 0], [8, 8, 4, 0], [256, 256, 0, 0], [32, 4, 8, 4]]",3420
13,"[[0, 0, 0, 0], [8, 8, 4, 0], [256, 256, 0, 0], [32, 4, 8, 4]]",3420,left,528,"[[0, 0, 0, 0], [16, 4, 0, 0], [512, 0, 4, 0], [32, 4, 8, 4]]",3948
13,"[[0, 0, 0, 0], [16, 4, 0, 0], [512, 0, 4, 0], [32, 4, 8, 4]]",3948,up,8,"[[16, 8, 4, 4], [512, 0, 8, 0], [32, 0, 0, 0], [0, 2, 0, 0]]",3956
13,"[[16, 8, 4, 4], [512, 0, 8, 0], [32, 0, 0, 0], [0, 2, 0, 0]]",3956,right,8,"[[0, 16, 8, 8], [0, 0, 512, 8], [0, 0, 0, 32], [0, 0, 2, 2]]",3964
13,"[[0, 16, 8, 8], [0, 0, 512, 8], [0, 0, 0, 32], [0, 0, 2, 2]]",3964,left,20,"[[16, 16, 0, 0], [512, 8, 4, 0], [32, 0, 0, 0], [4, 0, 0, 0]]",3984
13,"[[16, 16, 0, 0], [512, 8, 4, 0], [32, 0, 0, 0], [4, 0, 0, 0]]",3984,right,32,"[[0, 0, 0, 32], [0, 512, 8, 4], [0, 0, 0, 32], [2, 0, 0, 4]]",4016
13,"[[0, 0, 0, 32], [0, 512, 8, 4], [0, 0, 0, 32], [2, 0, 0, 4]]",4016,left,0,"[[32, 0, 0, 2], [512, 8, 4, 0], [32, 0, 0, 0], [2, 4, 0, 0]]",4016
13,"[[32, 0, 0, 2], [512, 8, 4, 0], [32, 0, 0, 0], [2, 4, 0, 0]]",4016,down,0,"[[32, 0, 0, 4], [512, 0, 0, 0], [32, 8, 0, 0], [2, 4, 4, 2]]",4016
13,"[[32, 0, 0, 4], [512, 0, 0, 0], [32, 8, 0, 0], [2, 4, 4, 2]]",4016,right,8,"[[0, 0, 32, 4], [0, 0, 0, 512], [2, 0, 32, 8], [0, 2, 8, 2]]",4024
13,"[[0, 0, 32, 4], [0, 0, 0, 512], [2, 0, 32, 8], [0, 2, 8, 2]]",4024,up,64,"[[2, 2, 64, 4], [0, 0, 8, 512], [0, 0, 0, 8], [0, 4, 0, 2]]",4088
13,"[[2, 2, 64, 4], [0, 0, 8, 512], [0, 0, 0, 8], [0, 4, 0, 2]]",4088,left,4,"[[4, 64, 4, 0], [8, 512, 0, 0], [8, 0, 4, 0], [4, 2, 0, 0]]",4092
13,"[[4, 64, 4, 0], [8, 512, 0, 0], [8, 0, 4, 0], [4, 2, 0, 0]]",4092,up,24,"[[4, 64, 8, 0], [16, 512, 0, 0], [4, 2, 2, 0], [0, 0, 0, 0]]",4116
13,"[[4, 64, 8, 0], [16, 512, 0, 0], [4, 2, 2, 0], [0, 0, 0, 0]]",4116,right,4,"[[0, 4, 64, 8], [0, 0, 16, 512], [0, 0, 4, 4], [0, 0, 0, 2]]",4120
13,"[[0, 4, 64, 8], [0, 0, 16, 512], [0, 0, 4, 4], [0, 0, 0, 2]]",4120,left,8,"[[4, 64, 8, 0], [16, 512, 0, 4], [8, 0, 0, 0], [2, 0, 0, 0]]",4128
13,"[[4, 64, 8, 0], [16, 512, 0, 4], [8, 0, 0, 0], [2, 0, 0, 0]]",4128,down,0,"[[4, 0, 0, 0], [16, 0, 0, 0], [8, 64, 0, 4], [2, 512, 8, 4]]",4128
13,"[[4, 0, 0, 0], [16, 0, 0, 0], [8, 64, 0, 4], [2, 512, 8, 4]]",4128,down,8,"[[4, 0, 0, 0], [16, 0, 0, 4], [8, 64, 0, 0], [2, 512, 8, 8]]",4136
13,"[[4, 0, 0, 0], [16, 0, 0, 4], [8, 64, 0, 0], [2, 512, 8, 8]]",4136,right,16,"[[4, 0, 0, 4], [0, 0, 16, 4], [0, 0, 8, 64], [0, 2, 512, 16]]",4152
13,"[[4, 0, 0, 4], [0, 0, 16, 4], [0, 0, 8, 64], [0, 2, 512, 16]]",4152,down,8,"[[0, 0, 0, 4], [0, 0, 16, 8], [0, 0, 8, 64], [4, 2, 512, 16]]",4160
13,"[[0, 0, 0, 4], [0, 0, 16, 8], [0, 0, 8, 64], [4, 2, 512, 16]]",4160,up,0,"[[4, 2, 16, 4], [0, 0, 8, 8], [0, 2, 512, 64], [0, 0, 0, 16]]",4160
13,"[[4, 2, 16, 4], [0, 0, 8, 8], [0, 2, 512, 64], [0, 0, 0, 16]]",4160,right,16,"[[4, 2, 16, 4], [0, 0, 0, 16], [0, 2, 512, 64], [0, 0, 4, 16]]",4176
13,"[[4, 2, 16, 4], [0, 0, 0, 16], [0, 2, 512, 64], [0, 0, 4, 16]]",4176,down,4,"[[0, 0, 0, 4], [0, 4, 16, 16], [0, 0, 512, 64], [4, 4, 4, 16]]",4180
13,"[[0, 0, 0, 4], [0, 4, 16, 16], [0, 0, 512, 64], [4, 4, 4, 16]]",4180,right,40,"[[0, 4, 0, 4], [0, 0, 4, 32], [0, 0, 512, 64], [0, 4, 8, 16]]",4220
13,"[[0, 4, 0, 4], [0, 0, 4, 32], [0, 0, 512, 64], [0, 4, 8, 16]]",4220,down,8,"[[0, 0, 0, 4], [0, 0, 4, 32], [2, 0, 512, 64], [0, 8, 8, 16]]",4228
13,"[[0, 0, 0, 4], [0, 0, 4, 32], [2, 0, 512, 64], [0, 8, 8, 16]]",4228,left,16,"[[4, 0, 0, 0], [4, 32, 0, 2], [2, 512, 64, 0], [16, 16, 0, 0]]",4244
13,"[[4, 0, 0, 0], [4, 32, 0, 2], [2, 512, 64, 0], [16, 16, 0, 0]]",4244,left,32,"[[4, 0, 0, 0], [4, 32, 2, 0], [2, 512, 64, 0], [32, 2, 0, 0]]",4276
13,"[[4, 0, 0, 0], [4, 32, 2, 0], [2, 512, 64, 0], [32, 2, 0, 0]]",4276,down,8,"[[0, 4, 0, 0], [8, 32, 0, 0], [2, 512, 2, 0], [32, 2, 64, 0]]",4284
13,"[[0, 4, 0, 0], [8, 32, 0, 0], [2, 512, 2, 0], [32, 2, 64, 0]]",4284,up,0,"[[8, 4, 2, 0], [2, 32, 64, 0], [32, 512, 0, 0], [0, 2, 0, 4]]",4284
13,"[[8, 4, 2, 0], [2, 32, 64, 0], [32, 512, 0, 0], [0, 2, 0, 4]]",4284,right,0,"[[0, 8, 4, 2], [0, 2, 32, 64], [0, 0, 32, 512], [0, 2, 2, 4]]",4284
13,"[[0, 8, 4, 2], [0, 2, 32, 64], [0, 0, 32, 512], [0, 2, 2, 4]]",4284,up,68,"[[0, 8, 4, 2], [2, 4, 64, 64], [0, 0, 2, 512], [0, 0, 0, 4]]",4352
13,"[[0, 8, 4, 2], [2, 4, 64, 64], [0, 0, 2, 512], [0, 0, 0, 4]]",4352,left,128,"[[8, 4, 2, 0], [2, 4, 128, 0], [2, 512, 0, 2], [4, 0, 0, 0]]",4480
13,"[[8, 4, 2, 0], [2, 4, 128, 0], [2, 512, 0, 2], [4, 0, 0, 0]]",4480,up,12,"[[8, 8, 2, 2], [4, 512, 128, 0], [4, 0, 2, 0], [0, 0, 0, 0]]",4492
13,"[[8, 8, 2, 2], [4, 512, 128, 0], [4, 0, 2, 0], [0, 0, 0, 0]]",4492,up,8,"[[8, 8, 2, 2], [8, 512, 128, 0], [0, 0, 2, 0], [0, 0, 0, 4]]",4500
13,"[[8, 8, 2, 2], [8, 512, 128, 0], [0, 0, 2, 0], [0, 0, 0, 4]]",4500,right,20,"[[4, 0, 16, 4], [0, 8, 512, 128], [0, 0, 0, 2], [0, 0, 0, 4]]",4520
13,"[[4, 0, 16, 4], [0, 8, 512, 128], [0, 0, 0, 2], [0, 0, 0, 4]]",4520,up,0,"[[4, 8, 16, 4], [0, 0, 512, 128], [0, 4, 0, 2], [0, 0, 0, 4]]",4520
13,"[[4, 8, 16, 4], [0, 0, 512, 128], [0, 4, 0, 2], [0, 0, 0, 4]]",4520,up,0,"[[4, 8, 16, 4], [2, 4, 512, 128], [0, 0, 0, 2], [0, 0, 0, 4]]",4520
13,"[[4, 8, 16, 4], [2, 4, 512, 128], [0, 0, 0, 2], [0, 0, 0, 4]]",4520,left,0,"[[4, 8, 16, 4], [2, 4, 512, 128], [2, 0, 0, 0], [4, 0, 0, 4]]",4520
13,"[[4, 8, 16, 4], [2, 4, 512, 128], [2, 0, 0, 0], [4, 0, 0, 4]]",4520,up,4,"[[4, 8, 16, 4], [4, 4, 512, 128], [4, 0, 2, 4], [0, 0, 0, 0]]",4524
13,"[[4, 8, 16, 4], [4, 4, 512, 128], [4, 0, 2, 4], [0, 0, 0, 0]]",4524,up,8,"[[8, 8, 16, 4], [4, 4, 512, 128], [0, 0, 2, 4], [2, 0, 0, 0]]",4532
13,"[[8, 8, 16, 4], [4, 4, 512, 128], [0, 0, 2, 4], [2, 0, 0, 0]]",4532,left,24,"[[16, 16, 4, 0], [8, 512, 128, 4], [2, 4, 0, 0], [2, 0, 0, 0]]",4556
13,"[[16, 16, 4, 0], [8, 512, 128, 4], [2, 4, 0, 0], [2, 0, 0, 0]]",4556,left,32,"[[32, 4, 0, 0], [8, 512, 128, 4], [2, 4, 0, 0], [2, 0, 4, 0]]",4588
13,"[[32, 4, 0, 0], [8, 512, 128, 4], [2, 4, 0, 0], [2, 0, 4, 0]]",4588,down,4,"[[4, 0, 0, 0], [32, 4, 0, 0], [8, 512, 128, 0], [4, 4, 4, 4]]",4592
13,"[[4, 0, 0, 0], [32, 4, 0, 0], [8, 512, 128, 0], [4, 4, 4, 4]]",4592,left,16,"[[4, 0, 0, 4], [32, 4, 0, 0], [8, 512, 128, 0], [8, 8, 0, 0]]",4608
13,"[[4, 0, 0, 4], [32, 4, 0, 0], [8, 512, 128, 0], [8, 8, 0, 0]]",4608,left,24,"[[8, 0, 0, 0], [32, 4, 4, 0], [8, 512, 128, 0], [16, 0, 0, 0]]",4632
13,"[[8, 0, 0, 0], [32, 4, 4, 0], [8, 512, 128, 0], [16, 0, 0, 0]]",4632,left,8,"[[8, 0, 0, 0], [32, 8, 2, 0], [8, 512, 128, 0], [16, 0, 0, 0]]",4640
13,"[[8, 0, 0, 0], [32, 8, 2, 0], [8, 512, 128, 0], [16, 0, 0, 0]]",4640,down,0,"[[8, 0, 0, 0], [32, 0, 0, 0], [8, 8, 2, 0], [16, 512, 128, 4]]",4640
13,"[[8, 0, 0, 0], [32, 0, 0, 0], [8, 8, 2, 0], [16, 512, 128, 4]]",4640,left,16,"[[8, 0, 0, 0], [32, 0, 0, 0], [16, 2, 0, 2], [16, 512, 128, 4]]",4656
13,"[[8, 0, 0, 0], [32, 0, 0, 0], [16, 2, 0, 2], [16, 512, 128, 4]]",4656,down,32,"[[0, 0, 0, 0], [8, 0, 2, 0], [32, 2, 0, 2], [32, 512, 128, 4]]",4688
13,"[[0, 0, 0, 0], [8, 0, 2, 0], [32, 2, 0, 2], [32, 512, 128, 4]]",4688,down,64,"[[0, 2, 0, 0], [0, 0, 0, 0], [8, 2, 2, 2], [64, 512, 128, 4]]",4752
13,"[[0, 2, 0, 0], [0, 0, 0, 0], [8, 2, 2, 2], [64, 512, 128, 4]]",4752,down,4,"[[0, 0, 0, 0], [2, 0, 0, 0], [8, 4, 2, 2], [64, 512, 128, 4]]",4756
13,"[[0, 0, 0, 0], [2, 0, 0, 0], [8, 4, 2, 2], [64, 512, 128, 4]]",4756,left,4,"[[4, 0, 0, 0], [2, 0, 0, 0], [8, 4, 4, 0], [64, 512, 128, 4]]",4760
13,"[[4, 0, 0, 0], [2, 0, 0, 0], [8, 4, 4, 0], [64, 512, 128, 4]]",4760,left,8,"[[4, 2, 0, 0], [2, 0, 0, 0], [8, 8, 0, 0], [64, 512, 128, 4]]",4768
13,"[[4, 2, 0, 0], [2, 0, 0, 0], [8, 8, 0, 0], [64, 512, 128, 4]]",4768,right,16,"[[0, 0, 4, 2], [2, 0, 0, 2], [0, 0, 0, 16], [64, 512, 128, 4]]",4784
13,"[[0, 0, 4, 2], [2, 0, 0, 2], [0, 0, 0, 16], [64, 512, 128, 4]]",4784,left,4,"[[4, 2, 0, 0], [4, 2, 0, 0], [16, 0, 0, 0], [64, 512, 128, 4]]",4788
13,"[[4, 2, 0, 0], [4, 2, 0, 0], [16, 0, 0, 0], [64, 512, 128, 4]]",4788,down,12,"[[0, 0, 0, 4], [8, 0, 0, 0], [16, 4, 0, 0], [64, 512, 128, 4]]",4800
13,"[[0, 0, 0, 4], [8, 0, 0, 0], [16, 4, 0, 0], [64, 512, 128, 4]]",4800,right,0,"[[0, 0, 0, 4], [0, 0, 4, 8], [0, 0, 16, 4], [64, 512, 128, 4]]",4800
13,"[[0, 0, 0, 4], [0, 0, 4, 8], [0, 0, 16, 4], [64, 512, 128, 4]]",4800,down,8,"[[0, 0, 0, 0], [2, 0, 4, 4], [0, 0, 16, 8], [64, 512, 128, 8]]",4808
13,"[[0, 0, 0, 0], [2, 0, 4, 4], [0, 0, 16, 8], [64, 512, 128, 8]]",4808,up,16,"[[2, 512, 4, 4], [64, 0, 16, 16], [0, 0, 128, 0], [0, 0, 0, 4]]",4824
13,"[[2, 512, 4, 4], [64, 0, 16, 16], [0, 0, 128, 0], [0, 0, 0, 4]]",4824,left,40,"[[2, 512, 8, 0], [64, 32, 0, 2], [128, 0, 0, 0], [4, 0, 0, 0]]",4864
13,"[[2, 512, 8, 0], [64, 32, 0, 2], [128, 0, 0, 0], [4, 0, 0, 0]]",4864,down,0,"[[2, 0, 0, 0], [64, 0, 0, 0], [128, 512, 4, 0], [4, 32, 8, 2]]",4864
13,"[[2, 0, 0, 0], [64, 0, 0, 0], [128, 512, 4, 0], [4, 32, 8, 2]]",4864,down,0,"[[2, 0, 0, 2], [64, 0, 0, 0], [128, 512, 4, 0], [4, 32, 8, 2]]",4864
13,"[[2, 0, 0, 2], [64, 0, 0, 0], [128, 512, 4, 0], [4, 32, 8, 2]]",4864,up,4,"[[2, 512, 4, 4], [64, 32, 8, 0], [128, 0, 0, 0], [4, 0, 2, 0]]",4868
13,"[[2, 512, 4, 4], [64, 32, 8, 0], [128, 0, 0, 0], [4, 0, 2, 0]]",4868,right,8,"[[0, 2, 512, 8], [0, 64, 32, 8], [0, 0, 0, 128], [2, 0, 4, 2]]",4876
13,"[[0, 2, 512, 8], [0, 64, 32, 8], [0, 0, 0, 128], [2, 0, 4, 2]]",4876,up,16,"[[2, 2, 512, 16], [0, 64, 32, 128], [0, 0, 4, 2], [0, 2, 0, 0]]",4892
13,"[[2, 2, 512, 16], [0, 64, 32, 128], [0, 0, 4, 2], [0, 2, 0, 0]]",4892,right,4,"[[0, 4, 512, 16], [0, 64, 32, 128], [0, 0, 4, 2], [4, 0, 0, 2]]",4896
13,"[[0, 4, 512, 16], [0, 64, 32, 128], [0, 0, 4, 2], [4, 0, 0, 2]]",4896,up,4,"[[4, 4, 512, 16], [0, 64, 32, 128], [0, 0, 4, 4], [0, 0, 0, 4]]",4900
13,"[[4, 4, 512, 16], [0, 64, 32, 128], [0, 0, 4, 4], [0, 0, 0, 4]]",4900,right,16,"[[0, 8, 512, 16], [0, 64, 32, 128], [0, 0, 0, 8], [4, 0, 0, 4]]",4916
13,"[[0, 8, 512, 16], [0, 64, 32, 128], [0, 0, 0, 8], [4, 0, 0, 4]]",4916,right,8,"[[0, 8, 512, 16], [0, 64, 32, 128], [0, 0, 0, 8], [0, 0, 4, 8]]",4924
13,"[[0, 8, 512, 16], [0, 64, 32, 128], [0, 0, 0, 8], [0, 0, 4, 8]]",4924,up,16,"[[0, 8, 512, 16], [4, 64, 32, 128], [0, 0, 4, 16], [0, 0, 0, 0]]",4940
13,"[[0, 8, 512, 16], [4, 64, 32, 128], [0, 0, 4, 16], [0, 0, 0, 0]]",4940,left,0,"[[8, 512, 16, 0], [4, 64, 32, 128], [4, 16, 0, 0], [0, 0, 0, 4]]",4940
13,"[[8, 512, 16, 0], [4, 64, 32, 128], [4, 16, 0, 0], [0, 0, 0, 4]]",4940,down,8,"[[0, 0, 0, 0], [4, 512, 0, 0], [8, 64, 16, 128], [8, 16, 32, 4]]",4948
13,"[[0, 0, 0, 0], [4, 512, 0, 0], [8, 64, 16, 128], [8, 16, 32, 4]]",4948,down,16,"[[0, 0, 0, 2], [0, 512, 0, 0], [4, 64, 16, 128], [16, 16, 32, 4]]",4964
13,"[[0, 0, 0, 2], [0, 512, 0, 0], [4, 64, 16, 128], [16, 16, 32, 4]]",4964,left,32,"[[2, 0, 0, 0], [512, 4, 0, 0], [4, 64, 16, 128], [32, 32, 4, 0]]",4996
13,"[[2, 0, 0, 0], [512, 4, 0, 0], [4, 64, 16, 128], [32, 32, 4, 0]]",4996,right,64,"[[0, 0, 0, 2], [0, 0, 512, 4], [4, 64, 16, 128], [4, 0, 64, 4]]",5060
13,"[[0, 0, 0, 2], [0, 0, 512, 4], [4, 64, 16, 128], [4, 0, 64, 4]]",5060,left,0,"[[2, 0, 0, 4], [512, 4, 0, 0], [4, 64, 16, 128], [4, 64, 4, 0]]",5060
13,"[[2, 0, 0, 4], [512, 4, 0, 0], [4, 64, 16, 128], [4, 64, 4, 0]]",5060,down,136,"[[4, 0, 0, 0], [2, 0, 0, 0], [512, 4, 16, 4], [8, 128, 4, 128]]",5196
13,"[[4, 0, 0, 0], [2, 0, 0, 0], [512, 4, 16, 4], [8, 128, 4, 128]]",5196,down,0,"[[4, 0, 0, 0], [2, 0, 4, 0], [512, 4, 16, 4], [8, 128, 4, 128]]",5196
13,"[[4, 0, 0, 0], [2, 0, 4, 0], [512, 4, 16, 4], [8, 128, 4, 128]]",5196,up,0,"[[4, 4, 4, 4], [2, 128, 16, 128], [512, 0, 4, 0], [8, 0, 4, 0]]",5196
13,"[[4, 4, 4, 4], [2, 128, 16, 128], [512, 0, 4, 0], [8, 0, 4, 0]]",5196,right,16,"[[0, 0, 8, 8], [2, 128, 16, 128], [0, 0, 512, 4], [4, 0, 8, 4]]",5212
13,"[[0, 0, 8, 8], [2, 128, 16, 128], [0, 0, 512, 4], [4, 0, 8, 4]]",5212,left,16,"[[16, 0, 0, 0], [2, 128, 16, 128], [512, 4, 0, 2], [4, 8, 4, 0]]",5228
13,"[[16, 0, 0, 0], [2, 128, 16, 128], [512, 4, 0, 2], [4, 8, 4, 0]]",5228,up,0,"[[16, 128, 16, 128], [2, 4, 4, 2], [512, 8, 0, 0], [4, 4, 0, 0]]",5228
13,"[[16, 128, 16, 128], [2, 4, 4, 2], [512, 8, 0, 0], [4, 4, 0, 0]]",5228,left,16,"[[16, 128, 16, 128], [2, 8, 2, 0], [512, 8, 0, 0], [8, 0, 0, 2]]",5244
13,"[[16, 128, 16, 128], [2, 8, 2, 0], [512, 8, 0, 0], [8, 0, 0, 2]]",5244,up,16,"[[16, 128, 16, 128], [2, 16, 2, 2], [512, 0, 0, 4], [8, 0, 0, 0]]",5260
13,"[[16, 128, 16, 128], [2, 16, 2, 2], [512, 0, 0, 4], [8, 0, 0, 0]]",5260,right,4,"[[16, 128, 16, 128], [0, 2, 16, 4], [0, 0, 512, 4], [4, 0, 0, 8]]",5264
13,"[[16, 128, 16, 128], [0, 2, 16, 4], [0, 0, 512, 4], [4, 0, 0, 8]]",5264,down,40,"[[0, 0, 0, 4], [0, 0, 0, 128], [16, 128, 32, 8], [4, 2, 512, 8]]",5304
13,"[[0, 0, 0, 4], [0, 0, 0, 128], [16, 128, 32, 8], [4, 2, 512, 8]]",5304,right,0,"[[0, 0, 0, 4], [0, 0, 2, 128], [16, 128, 32, 8], [4, 2, 512, 8]]",5304
13,"[[0, 0, 0, 4], [0, 0, 2, 128], [16, 128, 32, 8], [4, 2, 512, 8]]",5304,left,0,"[[4, 2, 0, 0], [2, 128, 0, 0], [16, 128, 32, 8], [4, 2, 512, 8]]",5304
13,"[[4, 2, 0, 0], [2, 128, 0, 0], [16, 128, 32, 8], [4, 2, 512, 8]]",5304,up,272,"[[4, 2, 32, 16], [2, 256, 512, 0], [16, 2, 0, 4], [4, 0, 0, 0]]",5576
13,"[[4, 2, 32, 16], [2, 256, 512, 0], [16, 2, 0, 4], [4, 0, 0, 0]]",5576,right,0,"[[4, 2, 32, 16], [0, 2, 256, 512], [0, 16, 2, 4], [0, 0, 2, 4]]",5576
13,"[[4, 2, 32, 16], [0, 2, 256, 512], [0, 16, 2, 4], [0, 0, 2, 4]]",5576,up,16,"[[4, 4, 32, 16], [0, 16, 256, 512], [0, 2, 4, 8], [0, 0, 0, 0]]",5592
13,"[[4, 4, 32, 16], [0, 16, 256, 512], [0, 2, 4, 8], [0, 0, 0, 0]]",5592,left,8,"[[8, 32, 16, 0], [16, 256, 512, 0], [2, 4, 8, 0], [4, 0, 0, 0]]",5600
13,"[[8, 32, 16, 0], [16, 256, 512, 0], [2, 4, 8, 0], [4, 0, 0, 0]]",5600,right,0,"[[0, 8, 32, 16], [0, 16, 256, 512], [0, 2, 4, 8], [0, 0, 4, 4]]",5600
13,"[[0, 8, 32, 16], [0, 16, 256, 512], [0, 2, 4, 8], [0, 0, 4, 4]]",5600,right,8,"[[2, 8, 32, 16], [0, 16, 256, 512], [0, 2, 4, 8], [0, 0, 0, 8]]",5608
13,"[[2, 8, 32, 16], [0, 16, 256, 512], [0, 2, 4, 8], [0, 0, 0, 8]]",5608,up,16,"[[2, 8, 32, 16], [0, 16, 256, 512], [0, 2, 4, 16], [4, 0, 0, 0]]",5624
13,"[[2, 8, 32, 16], [0, 16, 256, 512], [0, 2, 4, 16], [4, 0, 0, 0]]",5624,right,0,"[[2, 8, 32, 16], [0, 16, 256, 512], [0, 2, 4, 16], [0, 0, 2, 4]]",5624
13,"[[2, 8, 32, 16], [0, 16, 256, 512], [0, 2, 4, 16], [0, 0, 2, 4]]",5624,left,0,"[[2, 8, 32, 16], [16, 256, 512, 4], [2, 4, 16, 0], [2, 4, 0, 0]]",5624
13,"[[2, 8, 32, 16], [16, 256, 512, 4], [2, 4, 16, 0], [2, 4, 0, 0]]",5624,up,12,"[[2, 8, 32, 16], [16, 256, 512, 4], [4, 8, 16, 0], [0, 0, 0, 4]]",5636
13,"[[2, 8, 32, 16], [16, 256, 512, 4], [4, 8, 16, 0], [0, 0, 0, 4]]",5636,left,0,"[[2, 8, 32, 16], [16, 256, 512, 4], [4, 8, 16, 0], [4, 0, 0, 2]]",5636
13,"[[2, 8, 32, 16], [16, 256, 512, 4], [4, 8, 16, 0], [4, 0, 0, 2]]",5636,up,8,"[[2, 8, 32, 16], [16, 256, 512, 4], [8, 8, 16, 2], [0, 0, 0, 4]]",5644
13,"[[2, 8, 32, 16], [16, 256, 512, 4], [8, 8, 16, 2], [0, 0, 0, 4]]",5644,left,16,"[[2, 8, 32, 16], [16, 256, 512, 4], [16, 16, 2, 0], [4, 0, 4, 0]]",5660
13,"[[2, 8, 32, 16], [16, 256, 512, 4], [16, 16, 2, 0], [4, 0, 4, 0]]",5660,left,40,"[[2, 8, 32, 16], [16, 256, 512, 4], [32, 2, 0, 2], [8, 0, 0, 0]]",5700
13,"[[2, 8, 32, 16], [16, 256, 512, 4], [32, 2, 0, 2], [8, 0, 0, 0]]",5700,right,4,"[[2, 8, 32, 16], [16, 256, 512, 4], [0, 0, 32, 4], [0, 4, 0, 8]]",5704
13,"[[2, 8, 32, 16], [16, 256, 512, 4], [0, 0, 32, 4], [0, 4, 0, 8]]",5704,down,8,"[[0, 0, 0, 0], [4, 8, 32, 16], [2, 256, 512, 8], [16, 4, 32, 8]]",5712
13,"[[0, 0, 0, 0], [4, 8, 32, 16], [2, 256, 512, 8], [16, 4, 32, 8]]",5712,down,16,"[[4, 0, 0, 0], [4, 8, 32, 0], [2, 256, 512, 16], [16, 4, 32, 16]]",5728
13,"[[4, 0, 0, 0], [4, 8, 32, 0], [2, 256, 512, 16], [16, 4, 32, 16]]",5728,up,40,"[[8, 8, 32, 32], [2, 256, 512, 0], [16, 4, 32, 0], [0, 0, 0, 2]]",5768
13,"[[8, 8, 32, 32], [2, 256, 512, 0], [16, 4, 32, 0], [0, 0, 0, 2]]",5768,right,80,"[[0, 4, 16, 64], [0, 2, 256, 512], [0, 16, 4, 32], [0, 0, 0, 2]]",5848
13,"[[0, 4, 16, 64], [0, 2, 256, 512], [0, 16, 4, 32], [0, 0, 0, 2]]",5848,up,0,"[[0, 4, 16, 64], [0, 2, 256, 512], [0, 16, 4, 32], [0, 4, 0, 2]]",5848
13,"[[0, 4, 16, 64], [0, 2, 256, 512], [0, 16, 4, 32], [0, 4, 0, 2]]",5848,down,0,"[[0, 4, 0, 64], [4, 2, 16, 512], [0, 16, 256, 32], [0, 4, 4, 2]]",5848
13,"[[0, 4, 0, 64], [4, 2, 16, 512], [0, 16, 256, 32], [0, 4, 4, 2]]",5848,down,0,"[[0, 4, 0, 64], [4, 2, 16, 512], [0, 16, 256, 32], [4, 4, 4, 2]]",5848
13,"[[0, 4, 0, 64], [4, 2, 16, 512], [0, 16, 256, 32], [4, 4, 4, 2]]",5848,down,8,"[[0, 4, 0, 64], [0, 2, 16, 512], [4, 16, 256, 32], [8, 4, 4, 2]]",5856
13,"[[0, 4, 0, 64], [0, 2, 16, 512], [4, 16, 256, 32], [8, 4, 4, 2]]",5856,left,8,"[[4, 64, 0, 0], [2, 16, 512, 4], [4, 16, 256, 32], [8, 8, 2, 0]]",5864
13,"[[4, 64, 0, 0], [2, 16, 512, 4], [4, 16, 256, 32], [8, 8, 2, 0]]",5864,left,16,"[[4, 64, 0, 0], [2, 16, 512, 4], [4, 16, 256, 32], [16, 2, 0, 2]]",5880
13,"[[4, 64, 0, 0], [2, 16, 512, 4], [4, 16, 256, 32], [16, 2, 0, 2]]",5880,up,32,"[[4, 64, 512, 4], [2, 32, 256, 32], [4, 2, 0, 2], [16, 0, 0, 2]]",5912
13,"[[4, 64, 512, 4], [2, 32, 256, 32], [4, 2, 0, 2], [16, 0, 0, 2]]",5912,right,4,"[[4, 64, 512, 4], [2, 32, 256, 32], [0, 0, 4, 4], [0, 2, 16, 2]]",5916
13,"[[4, 64, 512, 4], [2, 32, 256, 32], [0, 0, 4, 4], [0, 2, 16, 2]]",5916,right,8,"[[4, 64, 512, 4], [2, 32, 256, 32], [0, 2, 0, 8], [0, 2, 16, 2]]",5924
13,"[[4, 64, 512, 4], [2, 32, 256, 32], [0, 2, 0, 8], [0, 2, 16, 2]]",5924,down,4,"[[4, 0, 0, 4], [0, 64, 512, 32], [4, 32, 256, 8], [2, 4, 16, 2]]",5928
13,"[[4, 0, 0, 4], [0, 64, 512, 32], [4, 32, 256, 8], [2, 4, 16, 2]]",5928,left,8,"[[8, 0, 0, 2], [64, 512, 32, 0], [4, 32, 256, 8], [2, 4, 16, 2]]",5936
13,"[[8, 0, 0, 2], [64, 512, 32, 0], [4, 32, 256, 8], [2, 4, 16, 2]]",5936,up,0,"[[8, 512, 32, 2], [64, 32, 256, 8], [4, 4, 16, 2], [2, 0, 0, 2]]",5936
13,"[[8, 512, 32, 2], [64, 32, 256, 8], [4, 4, 16, 2], [2, 0, 0, 2]]",5936,up,4,"[[8, 512, 32, 2], [64, 32, 256, 8], [4, 4, 16, 4], [2, 4, 0, 0]]",5940
13,"[[8, 512, 32, 2], [64, 32, 256, 8], [4, 4, 16, 4], [2, 4, 0, 0]]",5940,left,8,"[[8, 512, 32, 2], [64, 32, 256, 8], [8, 16, 4, 0], [2, 4, 0, 4]]",5948
13,"[[8, 512, 32, 2], [64, 32, 256, 8], [8, 16, 4, 0], [2, 4, 0, 4]]",5948,down,0,"[[8, 512, 4, 0], [64, 32, 32, 2], [8, 16, 256, 8], [2, 4, 4, 4]]",5948
13,"[[8, 512, 4, 0], [64, 32, 32, 2], [8, 16, 256, 8], [2, 4, 4, 4]]",5948,left,72,"[[8, 512, 4, 4], [64, 64, 2, 0], [8, 16, 256, 8], [2, 8, 4, 0]]",6020
13,"[[8, 512, 4, 4], [64, 64, 2, 0], [8, 16, 256, 8], [2, 8, 4, 0]]",6020,left,136,"[[8, 512, 8, 0], [128, 2, 2, 0], [8, 16, 256, 8], [2, 8, 4, 0]]",6156
13,"[[8, 512, 8, 0], [128, 2, 2, 0], [8, 16, 256, 8], [2, 8, 4, 0]]",6156,up,0,"[[8, 512, 8, 8], [128, 2, 2, 2], [8, 16, 256, 0], [2, 8, 4, 0]]",6156
13,"[[8, 512, 8, 8], [128, 2, 2, 2], [8, 16, 256, 0], [2, 8, 4, 0]]",6156,left,20,"[[8, 512, 16, 2], [128, 4, 2, 0], [8, 16, 256, 0], [2, 8, 4, 0]]",6176
13,"[[8, 512, 16, 2], [128, 4, 2, 0], [8, 16, 256, 0], [2, 8, 4, 0]]",6176,right,0,"[[8, 512, 16, 2], [0, 128, 4, 2], [4, 8, 16, 256], [0, 2, 8, 4]]",6176
13,"[[8, 512, 16, 2], [0, 128, 4, 2], [4, 8, 16, 256], [0, 2, 8, 4]]",6176,down,4,"[[0, 512, 16, 0], [4, 128, 4, 4], [8, 8, 16, 256], [4, 2, 8, 4]]",6180
13,"[[0, 512, 16, 0], [4, 128, 4, 4], [8, 8, 16, 256], [4, 2, 8, 4]]",6180,left,24,"[[512, 16, 0, 0], [4, 128, 8, 2], [16, 16, 256, 0], [4, 2, 8, 4]]",6204
13,"[[512, 16, 0, 0], [4, 128, 8, 2], [16, 16, 256, 0], [4, 2, 8, 4]]",6204,left,32,"[[512, 16, 2, 0], [4, 128, 8, 2], [32, 256, 0, 0], [4, 2, 8, 4]]",6236
13,"[[512, 16, 2, 0], [4, 128, 8, 2], [32, 256, 0, 0], [4, 2, 8, 4]]",6236,up,16,"[[512, 16, 2, 2], [4, 128, 16, 4], [32, 256, 0, 0], [4, 2, 4, 0]]",6252
13,"[[512, 16, 2, 2], [4, 128, 16, 4], [32, 256, 0, 0], [4, 2, 4, 0]]",6252,right,4,"[[2, 512, 16, 4], [4, 128, 16, 4], [0, 0, 32, 256], [0, 4, 2, 4]]",6256
13,"[[2, 512, 16, 4], [4, 128, 16, 4], [0, 0, 32, 256], [0, 4, 2, 4]]",6256,up,40,"[[2, 512, 32, 8], [4, 128, 32, 256], [0, 4, 2, 4], [0, 0, 2, 0]]",6296
13,"[[2, 512, 32, 8], [4, 128, 32, 256], [0, 4, 2, 4], [0, 0, 2, 0]]",6296,down,68,"[[2, 0, 0, 0], [0, 512, 0, 8], [2, 128, 64, 256], [4, 4, 4, 4]]",6364
13,"[[2, 0, 0, 0], [0, 512, 0, 8], [2, 128, 64, 256], [4, 4, 4, 4]]",6364,right,16,"[[0, 0, 4, 2], [0, 0, 512, 8], [2, 128, 64, 256], [0, 0, 8, 8]]",6380
13,"[[0, 0, 4, 2], [0, 0, 512, 8], [2, 128, 64, 256], [0, 0, 8, 8]]",6380,right,16,"[[0, 0, 4, 2], [0, 0, 512, 8], [2, 128, 64, 256], [0, 0, 4, 16]]",6396
13,"[[0, 0, 4, 2], [0, 0, 512, 8], [2, 128, 64, 256], [0, 0, 4, 16]]",6396,down,0,"[[0, 0, 4, 2], [0, 0, 512, 8], [4, 0, 64, 256], [2, 128, 4, 16]]",6396
13,"[[0, 0, 4, 2], [0, 0, 512, 8], [4, 0, 64, 256], [2, 128, 4, 16]]",6396,right,0,"[[4, 0, 4, 2], [0, 0, 512, 8], [0, 4, 64, 256], [2, 128, 4, 16]]",6396
13,"[[4, 0, 4, 2], [0, 0, 512, 8], [0, 4, 64, 256], [2, 128, 4, 16]]",6396,right,8,"[[2, 0, 8, 2], [0, 0, 512, 8], [0, 4, 64, 256], [2, 128, 4, 16]]",6404
13,"[[2, 0, 8, 2], [0, 0, 512, 8], [0, 4, 64, 256], [2, 128, 4, 16]]",6404,up,4,"[[4, 4, 8, 2], [0, 128, 512, 8], [0, 0, 64, 256], [0, 4, 4, 16]]",6408
13,"[[4, 4, 8, 2], [0, 128, 512, 8], [0, 0, 64, 256], [0, 4, 4, 16]]",6408,left,16,"[[8, 8, 2, 0], [128, 512, 8, 0], [64, 256, 0, 2], [8, 16, 0, 0]]",6424
13,"[[8, 8, 2, 0], [128, 512, 8, 0], [64, 256, 0, 2], [8, 16, 0, 0]]",6424,left,16,"[[16, 2, 0, 0], [128, 512, 8, 0], [64, 256, 2, 2], [8, 16, 0, 0]]",6440
13,"[[16, 2, 0, 0], [128, 512, 8, 0], [64, 256, 2, 2], [8, 16, 0, 0]]",6440,left,4,"[[16, 2, 0, 0], [128, 512, 8, 2], [64, 256, 4, 0], [8, 16, 0, 0]]",6444
13,"[[16, 2, 0, 0], [128, 512, 8, 2], [64, 256, 4, 0], [8, 16, 0, 0]]",6444,right,0,"[[4, 0, 16, 2], [128, 512, 8, 2], [0, 64, 256, 4], [0, 0, 8, 16]]",6444
13,"[[4, 0, 16, 2], [128, 512, 8, 2], [0, 64, 256, 4], [0, 0, 8, 16]]",6444,down,4,"[[0, 0, 16, 2], [0, 0, 8, 4], [4, 512, 256, 4], [128, 64, 8, 16]]",6448
13,"[[0, 0, 16, 2], [0, 0, 8, 4], [4, 512, 256, 4], [128, 64, 8, 16]]",6448,up,8,"[[4, 512, 16, 2], [128, 64, 8, 8], [0, 0, 256, 16], [0, 0, 8, 2]]",6456
13,"[[4, 512, 16, 2], [128, 64, 8, 8], [0, 0, 256, 16], [0, 0, 8, 2]]",6456,right,16,"[[4, 512, 16, 2], [0, 128, 64, 16], [0, 0, 256, 16], [4, 0, 8, 2]]",6472
13,"[[4, 512, 16, 2], [0, 128, 64, 16], [0, 0, 256, 16], [4, 0, 8, 2]]",6472,up,40,"[[8, 512, 16, 2], [0, 128, 64, 32], [0, 0, 256, 2], [0, 0, 8, 4]]",6512
13,"[[8, 512, 16, 2], [0, 128, 64, 32], [0, 0, 256, 2], [0, 0, 8, 4]]",6512,left,0,"[[8, 512, 16, 2], [128, 64, 32, 4], [256, 2, 0, 0], [8, 4, 0, 0]]",6512
13,"[[8, 512, 16, 2], [128, 64, 32, 4], [256, 2, 0, 0], [8, 4, 0, 0]]",6512,left,0,"[[8, 512, 16, 2], [128, 64, 32, 4], [256, 2, 0, 0], [8, 4, 0, 2]]",6512
13,"[[8, 512, 16, 2], [128, 64, 32, 4], [256, 2, 0, 0], [8, 4, 0, 2]]",6512,right,0,"[[8, 512, 16, 2], [128, 64, 32, 4], [0, 0, 256, 2], [2, 8, 4, 2]]",6512
13,"[[8, 512, 16, 2], [128, 64, 32, 4], [0, 0, 256, 2], [2, 8, 4, 2]]",6512,down,4,"[[2, 0, 16, 0], [8, 512, 32, 2], [128, 64, 256, 4], [2, 8, 4, 4]]",6516
13,"[[2, 0, 16, 0], [8, 512, 32, 2], [128, 64, 256, 4], [2, 8, 4, 4]]",6516,right,8,"[[0, 4, 2, 16], [8, 512, 32, 2], [128, 64, 256, 4], [0, 2, 8, 8]]",6524
13,"[[0, 4, 2, 16], [8, 512, 32, 2], [128, 64, 256, 4], [0, 2, 8, 8]]",6524,right,16,"[[2, 4, 2, 16], [8, 512, 32, 2], [128, 64, 256, 4], [0, 0, 2, 16]]",6540
13,"[[2, 4, 2, 16], [8, 512, 32, 2], [128, 64, 256, 4], [0, 0, 2, 16]]",6540,down,0,"[[0, 4, 2, 16], [2, 4, 32, 2], [8, 512, 256, 4], [128, 64, 2, 16]]",6540
13,"[[0, 4, 2, 16], [2, 4, 32, 2], [8, 512, 256, 4], [128, 64, 2, 16]]",6540,down,8,"[[0, 2, 2, 16], [2, 8, 32, 2], [8, 512, 256, 4], [128, 64, 2, 16]]",6548
13,"[[0, 2, 2, 16], [2, 8, 32, 2], [8, 512, 256, 4], [128, 64, 2, 16]]",6548,up,0,"[[2, 2, 2, 16], [8, 8, 32, 2], [128, 512, 256, 4], [2, 64, 2, 16]]",6548
13,"[[2, 2, 2, 16], [8, 8, 32, 2], [128, 512, 256, 4], [2, 64, 2, 16]]",6548,left,20,"[[4, 2, 16, 0], [16, 32, 2, 2], [128, 512, 256, 4], [2, 64, 2, 16]]",6568
13,"[[4, 2, 16, 0], [16, 32, 2, 2], [128, 512, 256, 4], [2, 64, 2, 16]]",6568,right,4,"[[0, 4, 2, 16], [4, 16, 32, 4], [128, 512, 256, 4], [2, 64, 2, 16]]",6572
13,"[[0, 4, 2, 16], [4, 16, 32, 4], [128, 512, 256, 4], [2, 64, 2, 16]]",6572,left,0,"[[4, 2, 16, 4], [4, 16, 32, 4], [128, 512, 256, 4], [2, 64, 2, 16]]",6572
13,"[[4, 2, 16, 4], [4, 16, 32, 4], [128, 512, 256, 4], [2, 64, 2, 16]]",6572,down,16,"[[4, 2, 16, 0], [8, 16, 32, 4], [128, 512, 256, 8], [2, 64, 2, 16]]",6588
13,"[[4, 2, 16, 0], [8, 16, 32, 4], [128, 512, 256, 8], [2, 64, 2, 16]]",6588,down,0,"[[4, 2, 16, 4], [8, 16, 32, 4], [128, 512, 256, 8], [2, 64, 2, 16]]",6588
13,"[[4, 2, 16, 4], [8, 16, 32, 4], [128, 512, 256, 8], [2, 64, 2, 16]]",6588,up,8,"[[4, 2, 16, 8], [8, 16, 32, 8], [128, 512, 256, 16], [2, 64, 2, 4]]",6596
13,"[[4, 2, 16, 8], [8, 16, 32, 8], [128, 512, 256, 16], [2, 64, 2, 4]]",6596,up,16,"[[4, 2, 16, 16], [8, 16, 32, 16], [128, 512, 256, 4], [2, 64, 2, 2]]",6612
13,"[[4, 2, 16, 16], [8, 16, 32, 16], [128, 512, 256, 4], [2, 64, 2, 2]]",6612,down,32,"[[4, 2, 16, 4], [8, 16, 32, 32], [128, 512, 256, 4], [2, 64, 2, 2]]",6644
13,"[[4, 2, 16, 4], [8, 16, 32, 32], [128, 512, 256, 4], [2, 64, 2, 2]]",6644,right,68,"[[4, 2, 16, 4], [0, 8, 16, 64], [128, 512, 256, 4], [4, 2, 64, 4]]",6712
13,"[[4, 2, 16, 4], [0, 8, 16, 64], [128, 512, 256, 4], [4, 2, 64, 4]]",6712,up,40,"[[4, 2, 32, 4], [128, 8, 256, 64], [4, 512, 64, 8], [2, 2, 0, 0]]",6752
13,"[[4, 2, 32, 4], [128, 8, 256, 64], [4, 512, 64, 8], [2, 2, 0, 0]]",6752,up,0,"[[4, 2, 32, 4], [128, 8, 256, 64], [4, 512, 64, 8], [2, 2, 2, 0]]",6752
13,"[[4, 2, 32, 4], [128, 8, 256, 64], [4, 512, 64, 8], [2, 2, 2, 0]]",6752,down,0,"[[4, 2, 32, 2], [128, 8, 256, 4], [4, 512, 64, 64], [2, 2, 2, 8]]",6752
13,"[[4, 2, 32, 2], [128, 8, 256, 4], [4, 512, 64, 64], [2, 2, 2, 8]]",6752,left,132,"[[4, 2, 32, 2], [128, 8, 256, 4], [4, 512, 128, 0], [4, 2, 8, 4]]",6884
13,"[[4, 2, 32, 2], [128, 8, 256, 4], [4, 512, 128, 0], [4, 2, 8, 4]]",6884,down,16,"[[0, 2, 32, 0], [4, 8, 256, 4], [128, 512, 128, 2], [8, 2, 8, 8]]",6900
13,"[[0, 2, 32, 0], [4, 8, 256, 4], [128, 512, 128, 2], [8, 2, 8, 8]]",6900,right,16,"[[4, 0, 2, 32], [4, 8, 256, 4], [128, 512, 128, 2], [0, 8, 2, 16]]",6916
13,"[[4, 0, 2, 32], [4, 8, 256, 4], [128, 512, 128, 2], [0, 8, 2, 16]]",6916,up,8,"[[8, 8, 2, 32], [128, 512, 256, 4], [0, 8, 128, 2], [2, 0, 2, 16]]",6924
13,"[[8, 8, 2, 32], [128, 512, 256, 4], [0, 8, 128, 2], [2, 0, 2, 16]]",6924,left,20,"[[16, 2, 32, 0], [128, 512, 256, 4], [8, 128, 2, 0], [4, 16, 2, 0]]",6944
13,"[[16, 2, 32, 0], [128, 512, 256, 4], [8, 128, 2, 0], [4, 16, 2, 0]]",6944,down,4,"[[16, 2, 0, 4], [128, 512, 32, 0], [8, 128, 256, 0], [4, 16, 4, 4]]",6948
13,"[[16, 2, 0, 4], [128, 512, 32, 0], [8, 128, 256, 0], [4, 16, 4, 4]]",6948,up,8,"[[16, 2, 32, 8], [128, 512, 256, 0], [8, 128, 4, 4], [4, 16, 0, 0]]",6956
13,"[[16, 2, 32, 8], [128, 512, 256, 0], [8, 128, 4, 4], [4, 16, 0, 0]]",6956,down,0,"[[16, 2, 0, 4], [128, 512, 32, 0], [8, 128, 256, 8], [4, 16, 4, 4]]",6956
13,"[[16, 2, 0, 4], [128, 512, 32, 0], [8, 128, 256, 8], [4, 16, 4, 4]]",6956,right,8,"[[2, 16, 2, 4], [0, 128, 512, 32], [8, 128, 256, 8], [0, 4, 16, 8]]",6964
13,"[[2, 16, 2, 4], [0, 128, 512, 32], [8, 128, 256, 8], [0, 4, 16, 8]]",6964,right,0,"[[2, 16, 2, 4], [0, 128, 512, 32], [8, 128, 256, 8], [2, 4, 16, 8]]",6964
13,"[[2, 16, 2, 4], [0, 128, 512, 32], [8, 128, 256, 8], [2, 4, 16, 8]]",6964,down,272,"[[0, 2, 2, 0], [2, 16, 512, 4], [8, 256, 256, 32], [2, 4, 16, 16]]",7236
13,"[[0, 2, 2, 0], [2, 16, 512, 4], [8, 256, 256, 32], [2, 4, 16, 16]]",7236,right,548,"[[0, 0, 0, 4], [2, 16, 512, 4], [2, 8, 512, 32], [0, 2, 4, 32]]",7784
13,"[[0, 0, 0, 4], [2, 16, 512, 4], [2, 8, 512, 32], [0, 2, 4, 32]]",7784,up,1100,"[[4, 16, 1024, 8], [0, 8, 4, 64], [2, 2, 0, 0], [0, 0, 0, 0]]",8884
13,"[[4, 16, 1024, 8], [0, 8, 4, 64], [2, 2, 0, 0], [0, 0, 0, 0]]",8884,right,4,"[[4, 16, 1024, 8], [0, 8, 4, 64], [4, 0, 0, 4], [0, 0, 0, 0]]",8888
13,"[[4, 16, 1024, 8], [0, 8, 4, 64], [4, 0, 0, 4], [0, 0, 0, 0]]",8888,down,8,"[[0, 0, 0, 0], [0, 4, 0, 8], [0, 16, 1024, 64], [8, 8, 4, 4]]",8896
13,"[[0, 0, 0, 0], [0, 4, 0, 8], [0, 16, 1024, 64], [8, 8, 4, 4]]",8896,left,24,"[[0, 0, 0, 0], [4, 8, 4, 0], [16, 1024, 64, 0], [16, 8, 0, 0]]",8920
13,"[[0, 0, 0, 0], [4, 8, 4, 0], [16, 1024, 64, 0], [16, 8, 0, 0]]",8920,up,32,"[[4, 8, 4, 0], [32, 1024, 64, 0], [4, 8, 0, 0], [0, 0, 0, 0]]",8952
13,"[[4, 8, 4, 0], [32, 1024, 64, 0], [4, 8, 0, 0], [0, 0, 0, 0]]",8952,left,0,"[[4, 8, 4, 0], [32, 1024, 64, 0], [4, 8, 0, 4], [0, 0, 0, 0]]",8952
13,"[[4, 8, 4, 0], [32, 1024, 64, 0], [4, 8, 0, 4], [0, 0, 0, 0]]",8952,up,0,"[[4, 8, 4, 4], [32, 1024, 64, 0], [4, 8, 0, 0], [0, 4, 0, 0]]",8952
13,"[[4, 8, 4, 4], [32, 1024, 64, 0], [4, 8, 0, 0], [0, 4, 0, 0]]",8952,left,8,"[[4, 8, 8, 4], [32, 1024, 64, 0], [4, 8, 0, 0], [4, 0, 0, 0]]",8960
13,"[[4, 8, 8, 4], [32, 1024, 64, 0], [4, 8, 0, 0], [4, 0, 0, 0]]",8960,up,8,"[[4, 8, 8, 4], [32, 1024, 64, 0], [8, 8, 0, 0], [0, 0, 4, 0]]",8968
13,"[[4, 8, 8, 4], [32, 1024, 64, 0], [8, 8, 0, 0], [0, 0, 4, 0]]",8968,left,32,"[[4, 16, 4, 4], [32, 1024, 64, 0], [16, 0, 0, 0], [4, 0, 0, 0]]",9000
13,"[[4, 16, 4, 4], [32, 1024, 64, 0], [16, 0, 0, 0], [4, 0, 0, 0]]",9000,down,0,"[[4, 0, 0, 0], [32, 0, 2, 0], [16, 16, 4, 0], [4, 1024, 64, 4]]",9000
13,"[[4, 0, 0, 0], [32, 0, 2, 0], [16, 16, 4, 0], [4, 1024, 64, 4]]",9000,right,32,"[[0, 0, 0, 4], [0, 0, 32, 2], [4, 0, 32, 4], [4, 1024, 64, 4]]",9032
13,"[[0, 0, 0, 4], [0, 0, 32, 2], [4, 0, 32, 4], [4, 1024, 64, 4]]",9032,up,80,"[[8, 1024, 64, 4], [0, 0, 64, 2], [0, 0, 4, 8], [0, 0, 0, 0]]",9112
13,"[[8, 1024, 64, 4], [0, 0, 64, 2], [0, 0, 4, 8], [0, 0, 0, 0]]",9112,up,128,"[[8, 1024, 128, 4], [0, 2, 4, 2], [0, 0, 0, 8], [0, 0, 0, 0]]",9240
13,"[[8, 1024, 128, 4], [0, 2, 4, 2], [0, 0, 0, 8], [0, 0, 0, 0]]",9240,right,0,"[[8, 1024, 128, 4], [0, 2, 4, 2], [0, 0, 0, 8], [0, 0, 0, 4]]",9240
13,"[[8, 1024, 128, 4], [0, 2, 4, 2], [0, 0, 0, 8], [0, 0, 0, 4]]",9240,down,0,"[[0, 0, 0, 4], [0, 0, 4, 2], [0, 1024, 128, 8], [8, 2, 4, 4]]",9240
13,"[[0, 0, 0, 4], [0, 0, 4, 2], [0, 1024, 128, 8], [8, 2, 4, 4]]",9240,right,8,"[[0, 0, 0, 4], [0, 0, 4, 2], [4, 1024, 128, 8], [0, 8, 2, 8]]",9248
13,"[[0, 0, 0, 4], [0, 0, 4, 2], [4, 1024, 128, 8], [0, 8, 2, 8]]",9248,down,16,"[[0, 0, 0, 4], [0, 0, 4, 4], [0, 1024, 128, 2], [4, 8, 2, 16]]",9264
13,"[[0, 0, 0, 4], [0, 0, 4, 4], [0, 1024, 128, 2], [4, 8, 2, 16]]",9264,left,8,"[[4, 0, 0, 0], [8, 4, 0, 0], [1024, 128, 2, 0], [4, 8, 2, 16]]",9272
13,"[[4, 0, 0, 0], [8, 4, 0, 0], [1024, 128, 2, 0], [4, 8, 2, 16]]",9272,up,4,"[[4, 4, 4, 16], [8, 128, 2, 0], [1024, 8, 0, 0], [4, 0, 0, 0]]",9276
13,"[[4, 4, 4, 16], [8, 128, 2, 0], [1024, 8, 0, 0], [4, 0, 0, 0]]",9276,left,8,"[[8, 4, 16, 0], [8, 128, 2, 0], [1024, 8, 0, 0], [4, 0, 0, 4]]",9284
13,"[[8, 4, 16, 0], [8, 128, 2, 0], [1024, 8, 0, 0], [4, 0, 0, 4]]",9284,right,8,"[[4, 8, 4, 16], [0, 8, 128, 2], [0, 0, 1024, 8], [0, 0, 0, 8]]",9292
13,"[[4, 8, 4, 16], [0, 8, 128, 2], [0, 0, 1024, 8], [0, 0, 0, 8]]",9292,down,32,"[[0, 0, 0, 0], [0, 4, 4, 16], [0, 0, 128, 2], [4, 16, 1024, 16]]",9324
13,"[[0, 0, 0, 0], [0, 4, 4, 16], [0, 0, 128, 2], [4, 16, 1024, 16]]",9324,right,8,"[[0, 0, 0, 0], [2, 0, 8, 16], [0, 0, 128, 2], [4, 16, 1024, 16]]",9332
13,"[[0, 0, 0, 0], [2, 0, 8, 16], [0, 0, 128, 2], [4, 16, 1024, 16]]",9332,left,0,"[[0, 0, 0, 0], [2, 8, 16, 4], [128, 2, 0, 0], [4, 16, 1024, 16]]",9332
13,"[[0, 0, 0, 0], [2, 8, 16, 4], [128, 2, 0, 0], [4, 16, 1024, 16]]",9332,up,0,"[[2, 8, 16, 4], [128, 2, 1024, 16], [4, 16, 0, 2], [0, 0, 0, 0]]",9332
13,"[[2, 8, 16, 4], [128, 2, 1024, 16], [4, 16, 0, 2], [0, 0, 0, 0]]",9332,down,0,"[[0, 2, 0, 0], [2, 8, 0, 4], [128, 2, 16, 16], [4, 16, 1024, 2]]",9332
13,"[[0, 2, 0, 0], [2, 8, 0, 4], [128, 2, 16, 16], [4, 16, 1024, 2]]",9332,left,32,"[[2, 0, 0, 2], [2, 8, 4, 0], [128, 2, 32, 0], [4, 16, 1024, 2]]",9364
13,"[[2, 0, 0, 2], [2, 8, 4, 0], [128, 2, 32, 0], [4, 16, 1024, 2]]",9364,up,8,"[[4, 8, 4, 4], [128, 2, 32, 0], [4, 16, 1024, 0], [0, 0, 4, 0]]",9372
13,"[[4, 8, 4, 4], [128, 2, 32, 0], [4, 16, 1024, 0], [0, 0, 4, 0]]",9372,left,8,"[[4, 8, 8, 0], [128, 2, 32, 0], [4, 16, 1024, 0], [4, 0, 0, 4]]",9380
13,"[[4, 8, 8, 0], [128, 2, 32, 0], [4, 16, 1024, 0], [4, 0, 0, 4]]",9380,left,24,"[[4, 16, 0, 0], [128, 2, 32, 0], [4, 16, 1024, 0], [8, 0, 4, 0]]",9404
13,"[[4, 16, 0, 0], [128, 2, 32, 0], [4, 16, 1024, 0], [8, 0, 4, 0]]",9404,right,0,"[[2, 0, 4, 16], [0, 128, 2, 32], [0, 4, 16, 1024], [0, 0, 8, 4]]",9404
13,"[[2, 0, 4, 16], [0, 128, 2, 32], [0, 4, 16, 1024], [0, 0, 8, 4]]",9404,up,0,"[[2, 128, 4, 16], [0, 4, 2, 32], [4, 0, 16, 1024], [0, 0, 8, 4]]",9404
13,"[[2, 128, 4, 16], [0, 4, 2, 32], [4, 0, 16, 1024], [0, 0, 8, 4]]",9404,down,0,"[[2, 0, 4, 16], [0, 0, 2, 32], [2, 128, 16, 1024], [4, 4, 8, 4]]",9404
13,"[[2, 0, 4, 16], [0, 0, 2, 32], [2, 128, 16, 1024], [4, 4, 8, 4]]",9404,left,8,"[[2, 4, 16, 2], [2, 32, 0, 0], [2, 128, 16, 1024], [8, 8, 4, 0]]",9412
13,"[[2, 4, 16, 2], [2, 32, 0, 0], [2, 128, 16, 1024], [8, 8, 4, 0]]",9412,up,36,"[[4, 4, 32, 2], [2, 32, 4, 1024], [8, 128, 0, 2], [0, 8, 0, 0]]",9448
13,"[[4, 4, 32, 2], [2, 32, 4, 1024], [8, 128, 0, 2], [0, 8, 0, 0]]",9448,left,8,"[[8, 32, 2, 0], [2, 32, 4, 1024], [8, 128, 2, 0], [8, 2, 0, 0]]",9456
13,"[[8, 32, 2, 0], [2, 32, 4, 1024], [8, 128, 2, 0], [8, 2, 0, 0]]",9456,down,80,"[[0, 0, 2, 0], [8, 64, 2, 0], [2, 128, 4, 0], [16, 2, 2, 1024]]",9536
13,"[[0, 0, 2, 0], [8, 64, 2, 0], [2, 128, 4, 0], [16, 2, 2, 1024]]",9536,up,4,"[[8, 64, 4, 1024], [2, 128, 4, 0], [16, 2, 2, 0], [0, 0, 0, 2]]",9540
13,"[[8, 64, 4, 1024], [2, 128, 4, 0], [16, 2, 2, 0], [0, 0, 0, 2]]",9540,down,8,"[[0, 0, 4, 0], [8, 64, 0, 0], [2, 128, 8, 1024], [16, 2, 2, 2]]",9548
13,"[[0, 0, 4, 0], [8, 64, 0, 0], [2, 128, 8, 1024], [16, 2, 2, 2]]",9548,right,4,"[[0, 0, 0, 4], [4, 0, 8, 64], [2, 128, 8, 1024], [0, 16, 2, 4]]",9552
13,"[[0, 0, 0, 4], [4, 0, 8, 64], [2, 128, 8, 1024], [0, 16, 2, 4]]",9552,up,16,"[[4, 128, 16, 4], [2, 16, 2, 64], [0, 0, 0, 1024], [0, 4, 0, 4]]",9568
13,"[[4, 128, 16, 4], [2, 16, 2, 64], [0, 0, 0, 1024], [0, 4, 0, 4]]",9568,down,0,"[[0, 0, 0, 4], [0, 128, 2, 64], [4, 16, 16, 1024], [2, 4, 2, 4]]",9568
13,"[[0, 0, 0, 4], [0, 128, 2, 64], [4, 16, 16, 1024], [2, 4, 2, 4]]",9568,right,32,"[[0, 0, 4, 4], [0, 128, 2, 64], [0, 4, 32, 1024], [2, 4, 2, 4]]",9600
13,"[[0, 0, 4, 4], [0, 128, 2, 64], [0, 4, 32, 1024], [2, 4, 2, 4]]",9600,up,8,"[[2, 128, 4, 4], [0, 8, 2, 64], [0, 2, 32, 1024], [0, 0, 2, 4]]",9608
13,"[[2, 128, 4, 4], [0, 8, 2, 64], [0, 2, 32, 1024], [0, 0, 2, 4]]",9608,left,8,"[[2, 128, 8, 0], [8, 2, 64, 0], [2, 32, 1024, 2], [2, 4, 0, 0]]",9616
13,"[[2, 128, 8, 0], [8, 2, 64, 0], [2, 32, 1024, 2], [2, 4, 0, 0]]",9616,down,4,"[[0, 128, 0, 0], [2, 2, 8, 0], [8, 32, 64, 2], [4, 4, 1024, 2]]",9620
13,"[[0, 128, 0, 0], [2, 2, 8, 0], [8, 32, 64, 2], [4, 4, 1024, 2]]",9620,left,12,"[[128, 0, 0, 0], [4, 8, 0, 4], [8, 32, 64, 2], [8, 1024, 2, 0]]",9632
13,"[[128, 0, 0, 0], [4, 8, 0, 4], [8, 32, 64, 2], [8, 1024, 2, 0]]",9632,down,16,"[[0, 0, 0, 2], [128, 8, 0, 0], [4, 32, 64, 4], [16, 1024, 2, 2]]",9648
13,"[[0, 0, 0, 2], [128, 8, 0, 0], [4, 32, 64, 4], [16, 1024, 2, 2]]",9648,right,4,"[[0, 2, 0, 2], [0, 0, 128, 8], [4, 32, 64, 4], [0, 16, 1024, 4]]",9652
13,"[[0, 2, 0, 2], [0, 0, 128, 8], [4, 32, 64, 4], [0, 16, 1024, 4]]",9652,down,8,"[[4, 0, 0, 0], [0, 2, 128, 2], [0, 32, 64, 8], [4, 16, 1024, 8]]",9660
13,"[[4, 0, 0, 0], [0, 2, 128, 2], [0, 32, 64, 8], [4, 16, 1024, 8]]",9660,up,24,"[[8, 2, 128, 2], [4, 32, 64, 16], [0, 16, 1024, 0], [0, 0, 0, 0]]",9684
13,"[[8, 2, 128, 2], [4, 32, 64, 16], [0, 16, 1024, 0], [0, 0, 0, 0]]",9684,right,0,"[[8, 2, 128, 2], [4, 32, 64, 16], [0, 0, 16, 1024], [0, 0, 4, 0]]",9684
13,"[[8, 2, 128, 2], [4, 32, 64, 16], [0, 0, 16, 1024], [0, 0, 4, 0]]",9684,down,0,"[[0, 2, 128, 0], [0, 0, 64, 2], [8, 2, 16, 16], [4, 32, 4, 1024]]",9684
13,"[[0, 2, 128, 0], [0, 0, 64, 2], [8, 2, 16, 16], [4, 32, 4, 1024]]",9684,left,32,"[[2, 128, 0, 0], [64, 2, 4, 0], [8, 2, 32, 0], [4, 32, 4, 1024]]",9716
13,"[[2, 128, 0, 0], [64, 2, 4, 0], [8, 2, 32, 0], [4, 32, 4, 1024]]",9716,up,4,"[[2, 128, 4, 1024], [64, 4, 32, 0], [8, 32, 4, 0], [4, 0, 2, 0]]",9720
13,"[[2, 128, 4, 1024], [64, 4, 32, 0], [8, 32, 4, 0], [4, 0, 2, 0]]",9720,right,0,"[[2, 128, 4, 1024], [0, 64, 4, 32], [0, 8, 32, 4], [0, 4, 4, 2]]",9720
13,"[[2, 128, 4, 1024], [0, 64, 4, 32], [0, 8, 32, 4], [0, 4, 4, 2]]",9720,right,8,"[[2, 128, 4, 1024], [0, 64, 4, 32], [2, 8, 32, 4], [0, 0, 8, 2]]",9728
13,"[[2, 128, 4, 1024], [0, 64, 4, 32], [2, 8, 32, 4], [0, 0, 8, 2]]",9728,left,0,"[[2, 128, 4, 1024], [64, 4, 32, 0], [2, 8, 32, 4], [8, 2, 2, 0]]",9728
13,"[[2, 128, 4, 1024], [64, 4, 32, 0], [2, 8, 32, 4], [8, 2, 2, 0]]",9728,down,64,"[[2, 128, 0, 4], [64, 4, 4, 0], [2, 8, 64, 1024], [8, 2, 2, 4]]",9792
13,"[[2, 128, 0, 4], [64, 4, 4, 0], [2, 8, 64, 1024], [8, 2, 2, 4]]",9792,right,12,"[[2, 2, 128, 4], [0, 0, 64, 8], [2, 8, 64, 1024], [0, 8, 4, 4]]",9804
13,"[[2, 2, 128, 4], [0, 0, 64, 8], [2, 8, 64, 1024], [0, 8, 4, 4]]",9804,up,148,"[[4, 2, 128, 4], [0, 16, 128, 8], [0, 0, 4, 1024], [4, 0, 0, 4]]",9952
13,"[[4, 2, 128, 4], [0, 16, 128, 8], [0, 0, 4, 1024], [4, 0, 0, 4]]",9952,down,264,"[[0, 0, 0, 4], [0, 2, 0, 8], [0, 2, 256, 1024], [8, 16, 4, 4]]",10216
13,"[[0, 0, 0, 4], [0, 2, 0, 8], [0, 2, 256, 1024], [8, 16, 4, 4]]",10216,left,8,"[[4, 0, 0, 0], [2, 8, 0, 0], [2, 256, 1024, 2], [8, 16, 8, 0]]",10224
13,"[[4, 0, 0, 0], [2, 8, 0, 0], [2, 256, 1024, 2], [8, 16, 8, 0]]",10224,up,4,"[[4, 8, 1024, 2], [4, 256, 8, 0], [8, 16, 0, 0], [0, 0, 0, 2]]",10228
13,"[[4, 8, 1024, 2], [4, 256, 8, 0], [8, 16, 0, 0], [0, 0, 0, 2]]",10228,down,12,"[[2, 0, 0, 0], [0, 8, 0, 0], [8, 256, 1024, 0], [8, 16, 8, 4]]",10240
13,"[[2, 0, 0, 0], [0, 8, 0, 0], [8, 256, 1024, 0], [8, 16, 8, 4]]",10240,down,16,"[[0, 2, 0, 0], [0, 8, 0, 0], [2, 256, 1024, 0], [16, 16, 8, 4]]",10256
13,"[[0, 2, 0, 0], [0, 8, 0, 0], [2, 256, 1024, 0], [16, 16, 8, 4]]",10256,left,32,"[[2, 0, 0, 0], [8, 0, 0, 0], [2, 256, 1024, 2], [32, 8, 4, 0]]",10288
13,"[[2, 0, 0, 0], [8, 0, 0, 0], [2, 256, 1024, 2], [32, 8, 4, 0]]",10288,up,0,"[[2, 256, 1024, 2], [8, 8, 4, 0], [2, 0, 0, 0], [32, 0, 4, 0]]",10288
13,"[[2, 256, 1024, 2], [8, 8, 4, 0], [2, 0, 0, 0], [32, 0, 4, 0]]",10288,left,16,"[[2, 256, 1024, 2], [16, 4, 0, 0], [2, 0, 0, 4], [32, 4, 0, 0]]",10304
13,"[[2, 256, 1024, 2], [16, 4, 0, 0], [2, 0, 0, 4], [32, 4, 0, 0]]",10304,up,8,"[[2, 256, 1024, 2], [16, 8, 0, 4], [2, 2, 0, 0], [32, 0, 0, 0]]",10312
13,"[[2, 256, 1024, 2], [16, 8, 0, 4], [2, 2, 0, 0], [32, 0, 0, 0]]",10312,right,4,"[[2, 256, 1024, 2], [0, 16, 8, 4], [0, 0, 0, 4], [4, 0, 0, 32]]",10316
13,"[[2, 256, 1024, 2], [0, 16, 8, 4], [0, 0, 0, 4], [4, 0, 0, 32]]",10316,up,8,"[[2, 256, 1024, 2], [4, 16, 8, 8], [0, 2, 0, 32], [0, 0, 0, 0]]",10324
13,"[[2, 256, 1024, 2], [4, 16, 8, 8], [0, 2, 0, 32], [0, 0, 0, 0]]",10324,right,16,"[[2, 256, 1024, 2], [0, 4, 16, 16], [0, 4, 2, 32], [0, 0, 0, 0]]",10340
13,"[[2, 256, 1024, 2], [0, 4, 16, 16], [0, 4, 2, 32], [0, 0, 0, 0]]",10340,right,32,"[[2, 256, 1024, 2], [0, 0, 4, 32], [0, 4, 2, 32], [2, 0, 0, 0]]",10372
13,"[[2, 256, 1024, 2], [0, 0, 4, 32], [0, 4, 2, 32], [2, 0, 0, 0]]",10372,up,68,"[[4, 256, 1024, 2], [0, 4, 4, 64], [0, 0, 2, 2], [0, 0, 0, 0]]",10440
13,"[[4, 256, 1024, 2], [0, 4, 4, 64], [0, 0, 2, 2], [0, 0, 0, 0]]",10440,right,12,"[[4, 256, 1024, 2], [0, 0, 8, 64], [0, 2, 0, 4], [0, 0, 0, 0]]",10452
13,"[[4, 256, 1024, 2], [0, 0, 8, 64], [0, 2, 0, 4], [0, 0, 0, 0]]",10452,up,0,"[[4, 256, 1024, 2], [2, 2, 8, 64], [0, 0, 0, 4], [0, 0, 0, 0]]",10452
13,"[[4, 256, 1024, 2], [2, 2, 8, 64], [0, 0, 0, 4], [0, 0, 0, 0]]",10452,left,4,"[[4, 256, 1024, 2], [4, 8, 64, 0], [4, 0, 2, 0], [0, 0, 0, 0]]",10456
13,"[[4, 256, 1024, 2], [4, 8, 64, 0], [4, 0, 2, 0], [0, 0, 0, 0]]",10456,down,8,"[[0, 0, 0, 0], [0, 0, 1024, 0], [4, 256, 64, 2], [8, 8, 2, 2]]",10464
13,"[[0, 0, 0, 0], [0, 0, 1024, 0], [4, 256, 64, 2], [8, 8, 2, 2]]",10464,left,20,"[[0, 0, 0, 0], [1024, 0, 0, 0], [4, 256, 64, 2], [16, 4, 0, 2]]",10484
13,"[[0, 0, 0, 0], [1024, 0, 0, 0], [4, 256, 64, 2], [16, 4, 0, 2]]",10484,up,4,"[[1024, 256, 64, 4], [4, 4, 0, 0], [16, 0, 2, 0], [0, 0, 0, 0]]",10488
13,"[[1024, 256, 64, 4], [4, 4, 0, 0], [16, 0, 2, 0], [0, 0, 0, 0]]",10488,left,8,"[[1024, 256, 64, 4], [8, 0, 0, 2], [16, 2, 0, 0], [0, 0, 0, 0]]",10496
13,"[[1024, 256, 64, 4], [8, 0, 0, 2], [16, 2, 0, 0], [0, 0, 0, 0]]",10496,up,0,"[[1024, 256, 64, 4], [8, 2, 0, 2], [16, 0, 0, 0], [2, 0, 0, 0]]",10496
13,"[[1024, 256, 64, 4], [8, 2, 0, 2], [16, 0, 0, 0], [2, 0, 0, 0]]",10496,left,4,"[[1024, 256, 64, 4], [8, 4, 0, 0], [16, 0, 0, 0], [2, 0, 0, 4]]",10500
13,"[[1024, 256, 64, 4], [8, 4, 0, 0], [16, 0, 0, 0], [2, 0, 0, 4]]",10500,left,0,"[[1024, 256, 64, 4], [8, 4, 0, 0], [16, 0, 0, 0], [2, 4, 0, 4]]",10500
13,"[[1024, 256, 64, 4], [8, 4, 0, 0], [16, 0, 0, 0], [2, 4, 0, 4]]",10500,up,16,"[[1024, 256, 64, 8], [8, 8, 0, 0], [16, 0, 0, 0], [2, 4, 0, 0]]",10516
13,"[[1024, 256, 64, 8], [8, 8, 0, 0], [16, 0, 0, 0], [2, 4, 0, 0]]",10516,right,16,"[[1024, 256, 64, 8], [0, 0, 0, 16], [0, 0, 0, 16], [4, 0, 2, 4]]",10532
13,"[[1024, 256, 64, 8], [0, 0, 0, 16], [0, 0, 0, 16], [4, 0, 2, 4]]",10532,up,32,"[[1024, 256, 64, 8], [4, 0, 2, 32], [0, 2, 0, 4], [0, 0, 0, 0]]",10564
13,"[[1024, 256, 64, 8], [4, 0, 2, 32], [0, 2, 0, 4], [0, 0, 0, 0]]",10564,right,0,"[[1024, 256, 64, 8], [0, 4, 2, 32], [0, 0, 2, 4], [0, 4, 0, 0]]",10564
13,"[[1024, 256, 64, 8], [0, 4, 2, 32], [0, 0, 2, 4], [0, 4, 0, 0]]",10564,down,12,"[[0, 0, 0, 0], [0, 0, 0, 8], [2, 256, 64, 32], [1024, 8, 4, 4]]",10576
13,"[[0, 0, 0, 0], [0, 0, 0, 8], [2, 256, 64, 32], [1024, 8, 4, 4]]",10576,right,8,"[[0, 0, 0, 0], [0, 0, 2, 8], [2, 256, 64, 32], [0, 1024, 8, 8]]",10584
13,"[[0, 0, 0, 0], [0, 0, 2, 8], [2, 256, 64, 32], [0, 1024, 8, 8]]",10584,right,16,"[[0, 0, 0, 0], [0, 0, 2, 8], [2, 256, 64, 32], [4, 0, 1024, 16]]",10600
13,"[[0, 0, 0, 0], [0, 0, 2, 8], [2, 256, 64, 32], [4, 0, 1024, 16]]",10600,left,0,"[[0, 0, 0, 0], [2, 8, 0, 0], [2, 256, 64, 32], [4, 1024, 16, 4]]",10600
13,"[[0, 0, 0, 0], [2, 8, 0, 0], [2, 256, 64, 32], [4, 1024, 16, 4]]",10600,up,4,"[[4, 8, 64, 32], [4, 256, 16, 4], [0, 1024, 0, 2], [0, 0, 0, 0]]",10604
13,"[[4, 8, 64, 32], [4, 256, 16, 4], [0, 1024, 0, 2], [0, 0, 0, 0]]",10604,up,8,"[[8, 8, 64, 32], [0, 256, 16, 4], [0, 1024, 0, 2], [0, 2, 0, 0]]",10612
13,"[[8, 8, 64, 32], [0, 256, 16, 4], [0, 1024, 0, 2], [0, 2, 0, 0]]",10612,right,16,"[[0, 16, 64, 32], [0, 256, 16, 4], [0, 0, 1024, 2], [0, 4, 0, 2]]",10628
13,"[[0, 16, 64, 32], [0, 256, 16, 4], [0, 0, 1024, 2], [0, 4, 0, 2]]",10628,up,4,"[[0, 16, 64, 32], [0, 256, 16, 4], [0, 4, 1024, 4], [0, 0, 2, 0]]",10632
13,"[[0, 16, 64, 32], [0, 256, 16, 4], [0, 4, 1024, 4], [0, 0, 2, 0]]",10632,down,8,"[[0, 0, 64, 2], [0, 16, 16, 0], [0, 256, 1024, 32], [0, 4, 2, 8]]",10640
13,"[[0, 0, 64, 2], [0, 16, 16, 0], [0, 256, 1024, 32], [0, 4, 2, 8]]",10640,right,32,"[[0, 0, 64, 2], [0, 0, 0, 32], [2, 256, 1024, 32], [0, 4, 2, 8]]",10672
13,"[[0, 0, 64, 2], [0, 0, 0, 32], [2, 256, 1024, 32], [0, 4, 2, 8]]",10672,up,64,"[[2, 256, 64, 2], [4, 4, 1024, 64], [0, 0, 2, 8], [0, 0, 0, 0]]",10736
13,"[[2, 256, 64, 2], [4, 4, 1024, 64], [0, 0, 2, 8], [0, 0, 0, 0]]",10736,right,8,"[[2, 256, 64, 2], [0, 8, 1024, 64], [0, 4, 2, 8], [0, 0, 0, 0]]",10744
13,"[[2, 256, 64, 2], [0, 8, 1024, 64], [0, 4, 2, 8], [0, 0, 0, 0]]",10744,left,0,"[[2, 256, 64, 2], [8, 1024, 64, 0], [4, 2, 8, 0], [0, 0, 4, 0]]",10744
13,"[[2, 256, 64, 2], [8, 1024, 64, 0], [4, 2, 8, 0], [0, 0, 4, 0]]",10744,up,128,"[[2, 256, 128, 2], [8, 1024, 8, 0], [4, 2, 4, 2], [0, 0, 0, 0]]",10872
13,"[[2, 256, 128, 2], [8, 1024, 8, 0], [4, 2, 4, 2], [0, 0, 0, 0]]",10872,down,4,"[[0, 0, 0, 4], [2, 256, 128, 0], [8, 1024, 8, 0], [4, 2, 4, 4]]",10876
13,"[[0, 0, 0, 4], [2, 256, 128, 0], [8, 1024, 8, 0], [4, 2, 4, 4]]",10876,left,8,"[[4, 0, 4, 0], [2, 256, 128, 0], [8, 1024, 8, 0], [4, 2, 8, 0]]",10884
13,"[[4, 0, 4, 0], [2, 256, 128, 0], [8, 1024, 8, 0], [4, 2, 8, 0]]",10884,down,16,"[[4, 2, 0, 0], [2, 256, 4, 0], [8, 1024, 128, 0], [4, 2, 16, 0]]",10900
13,"[[4, 2, 0, 0], [2, 256, 4, 0], [8, 1024, 128, 0], [4, 2, 16, 0]]",10900,right,0,"[[0, 0, 4, 2], [0, 2, 256, 4], [0, 8, 1024, 128], [4, 4, 2, 16]]",10900
13,"[[0, 0, 4, 2], [0, 2, 256, 4], [0, 8, 1024, 128], [4, 4, 2, 16]]",10900,right,8,"[[2, 0, 4, 2], [0, 2, 256, 4], [0, 8, 1024, 128], [0, 8, 2, 16]]",10908
13,"[[2, 0, 4, 2], [0, 2, 256, 4], [0, 8, 1024, 128], [0, 8, 2, 16]]",10908,up,16,"[[2, 2, 4, 2], [0, 16, 256, 4], [0, 0, 1024, 128], [4, 0, 2, 16]]",10924
13,"[[2, 2, 4, 2], [0, 16, 256, 4], [0, 0, 1024, 128], [4, 0, 2, 16]]",10924,left,4,"[[4, 4, 2, 0], [16, 256, 4, 2], [1024, 128, 0, 0], [4, 2, 16, 0]]",10928
13,"[[4, 4, 2, 0], [16, 256, 4, 2], [1024, 128, 0, 0], [4, 2, 16, 0]]",10928,up,0,"[[4, 4, 2, 2], [16, 256, 4, 2], [1024, 128, 16, 0], [4, 2, 0, 0]]",10928
13,"[[4, 4, 2, 2], [16, 256, 4, 2], [1024, 128, 16, 0], [4, 2, 0, 0]]",10928,left,12,"[[8, 4, 0, 0], [16, 256, 4, 2], [1024, 128, 16, 4], [4, 2, 0, 0]]",10940
13,"[[8, 4, 0, 0], [16, 256, 4, 2], [1024, 128, 16, 4], [4, 2, 0, 0]]",10940,up,0,"[[8, 4, 4, 2], [16, 256, 16, 4], [1024, 128, 0, 0], [4, 2, 0, 4]]",10940
13,"[[8, 4, 4, 2], [16, 256, 16, 4], [1024, 128, 0, 0], [4, 2, 0, 4]]",10940,left,8,"[[8, 8, 2, 0], [16, 256, 16, 4], [1024, 128, 0, 0], [4, 2, 4, 2]]",10948
13,"[[8, 8, 2, 0], [16, 256, 16, 4], [1024, 128, 0, 0], [4, 2, 4, 2]]",10948,left,16,"[[16, 2, 4, 0], [16, 256, 16, 4], [1024, 128, 0, 0], [4, 2, 4, 2]]",10964
13,"[[16, 2, 4, 0], [16, 256, 16, 4], [1024, 128, 0, 0], [4, 2, 4, 2]]",10964,up,32,"[[32, 2, 4, 4], [1024, 256, 16, 2], [4, 128, 4, 0], [4, 2, 0, 0]]",10996
13,"[[32, 2, 4, 4], [1024, 256, 16, 2], [4, 128, 4, 0], [4, 2, 0, 0]]",10996,up,8,"[[32, 2, 4, 4], [1024, 256, 16, 2], [8, 128, 4, 2], [0, 2, 0, 0]]",11004
13,"[[32, 2, 4, 4], [1024, 256, 16, 2], [8, 128, 4, 2], [0, 2, 0, 0]]",11004,up,4,"[[32, 2, 4, 4], [1024, 256, 16, 4], [8, 128, 4, 0], [0, 2, 2, 0]]",11008
13,"[[32, 2, 4, 4], [1024, 256, 16, 4], [8, 128, 4, 0], [0, 2, 2, 0]]",11008,right,12,"[[2, 32, 2, 8], [1024, 256, 16, 4], [0, 8, 128, 4], [0, 0, 0, 4]]",11020
13,"[[2, 32, 2, 8], [1024, 256, 16, 4], [0, 8, 128, 4], [0, 0, 0, 4]]",11020,up,8,"[[2, 32, 2, 8], [1024, 256, 16, 8], [0, 8, 128, 4], [2, 0, 0, 0]]",11028
13,"[[2, 32, 2, 8], [1024, 256, 16, 8], [0, 8, 128, 4], [2, 0, 0, 0]]",11028,down,16,"[[0, 0, 4, 0], [2, 32, 2, 0], [1024, 256, 16, 16], [2, 8, 128, 4]]",11044
13,"[[0, 0, 4, 0], [2, 32, 2, 0], [1024, 256, 16, 16], [2, 8, 128, 4]]",11044,left,32,"[[4, 0, 0, 0], [2, 32, 2, 2], [1024, 256, 32, 0], [2, 8, 128, 4]]",11076
13,"[[4, 0, 0, 0], [2, 32, 2, 2], [1024, 256, 32, 0], [2, 8, 128, 4]]",11076,down,0,"[[4, 0, 4, 0], [2, 32, 2, 0], [1024, 256, 32, 2], [2, 8, 128, 4]]",11076
13,"[[4, 0, 4, 0], [2, 32, 2, 0], [1024, 256, 32, 2], [2, 8, 128, 4]]",11076,right,8,"[[0, 0, 0, 8], [2, 2, 32, 2], [1024, 256, 32, 2], [2, 8, 128, 4]]",11084
13,"[[0, 0, 0, 8], [2, 2, 32, 2], [1024, 256, 32, 2], [2, 8, 128, 4]]",11084,up,68,"[[2, 2, 64, 8], [1024, 256, 128, 4], [2, 8, 0, 4], [2, 0, 0, 0]]",11152
13,"[[2, 2, 64, 8], [1024, 256, 128, 4], [2, 8, 0, 4], [2, 0, 0, 0]]",11152,down,12,"[[0, 0, 4, 0], [2, 2, 0, 0], [1024, 256, 64, 8], [4, 8, 128, 8]]",11164
13,"[[0, 0, 4, 0], [2, 2, 0, 0], [1024, 256, 64, 8], [4, 8, 128, 8]]",11164,up,16,"[[2, 2, 4, 16], [1024, 256, 64, 2], [4, 8, 128, 0], [0, 0, 0, 0]]",11180
13,"[[2, 2, 4, 16], [1024, 256, 64, 2], [4, 8, 128, 0], [0, 0, 0, 0]]",11180,left,4,"[[4, 4, 16, 2], [1024, 256, 64, 2], [4, 8, 128, 0], [0, 0, 0, 0]]",11184
13,"[[4, 4, 16, 2], [1024, 256, 64, 2], [4, 8, 128, 0], [0, 0, 0, 0]]",11184,down,4,"[[0, 0, 0, 0], [4, 4, 16, 2], [1024, 256, 64, 0], [4, 8, 128, 4]]",11188
13,"[[0, 0, 0, 0], [4, 4, 16, 2], [1024, 256, 64, 0], [4, 8, 128, 4]]",11188,left,8,"[[0, 4, 0, 0], [8, 16, 2, 0], [1024, 256, 64, 0], [4, 8, 128, 4]]",11196
13,"[[0, 4, 0, 0], [8, 16, 2, 0], [1024, 256, 64, 0], [4, 8, 128, 4]]",11196,right,0,"[[0, 0, 0, 4], [0, 8, 16, 2], [4, 1024, 256, 64], [4, 8, 128, 4]]",11196
13,"[[0, 0, 0, 4], [0, 8, 16, 2], [4, 1024, 256, 64], [4, 8, 128, 4]]",11196,up,8,"[[8, 8, 16, 4], [0, 1024, 256, 2], [0, 8, 128, 64], [0, 0, 2, 4]]",11204
13,"[[8, 8, 16, 4], [0, 1024, 256, 2], [0, 8, 128, 64], [0, 0, 2, 4]]",11204,left,16,"[[16, 16, 4, 0], [1024, 256, 2, 0], [8, 128, 64, 4], [2, 4, 0, 0]]",11220
13,"[[16, 16, 4, 0], [1024, 256, 2, 0], [8, 128, 64, 4], [2, 4, 0, 0]]",11220,left,32,"[[32, 4, 2, 0], [1024, 256, 2, 0], [8, 128, 64, 4], [2, 4, 0, 0]]",11252
13,"[[32, 4, 2, 0], [1024, 256, 2, 0], [8, 128, 64, 4], [2, 4, 0, 0]]",11252,up,4,"[[32, 4, 4, 4], [1024, 256, 64, 0], [8, 128, 0, 0], [2, 4, 0, 2]]",11256
13,"[[32, 4, 4, 4], [1024, 256, 64, 0], [8, 128, 0, 0], [2, 4, 0, 2]]",11256,left,8,"[[32, 8, 4, 0], [1024, 256, 64, 0], [8, 128, 0, 2], [2, 4, 2, 0]]",11264
13,"[[32, 8, 4, 0], [1024, 256, 64, 0], [8, 128, 0, 2], [2, 4, 2, 0]]",11264,left,0,"[[32, 8, 4, 0], [1024, 256, 64, 4], [8, 128, 2, 0], [2, 4, 2, 0]]",11264
13,"[[32, 8, 4, 0], [1024, 256, 64, 4], [8, 128, 2, 0], [2, 4, 2, 0]]",11264,up,4,"[[32, 8, 4, 4], [1024, 256, 64, 0], [8, 128, 4, 0], [2, 4, 4, 0]]",11268
13,"[[32, 8, 4, 4], [1024, 256, 64, 0], [8, 128, 4, 0], [2, 4, 4, 0]]",11268,right,16,"[[0, 32, 8, 8], [4, 1024, 256, 64], [0, 8, 128, 4], [0, 0, 2, 8]]",11284
13,"[[0, 32, 8, 8], [4, 1024, 256, 64], [0, 8, 128, 4], [0, 0, 2, 8]]",11284,right,16,"[[0, 0, 32, 16], [4, 1024, 256, 64], [0, 8, 128, 4], [4, 0, 2, 8]]",11300
13,"[[0, 0, 32, 16], [4, 1024, 256, 64], [0, 8, 128, 4], [4, 0, 2, 8]]",11300,down,8,"[[0, 0, 32, 16], [0, 4, 256, 64], [0, 1024, 128, 4], [8, 8, 2, 8]]",11308
13,"[[0, 0, 32, 16], [0, 4, 256, 64], [0, 1024, 128, 4], [8, 8, 2, 8]]",11308,left,16,"[[32, 16, 0, 0], [4, 256, 64, 2], [1024, 128, 4, 0], [16, 2, 8, 0]]",11324
13,"[[32, 16, 0, 0], [4, 256, 64, 2], [1024, 128, 4, 0], [16, 2, 8, 0]]",11324,up,0,"[[32, 16, 64, 2], [4, 256, 4, 0], [1024, 128, 8, 0], [16, 2, 4, 0]]",11324
13,"[[32, 16, 64, 2], [4, 256, 4, 0], [1024, 128, 8, 0], [16, 2, 4, 0]]",11324,left,0,"[[32, 16, 64, 2], [4, 256, 4, 0], [1024, 128, 8, 0], [16, 2, 4, 4]]",11324
13,"[[32, 16, 64, 2], [4, 256, 4, 0], [1024, 128, 8, 0], [16, 2, 4, 4]]",11324,left,8,"[[32, 16, 64, 2], [4, 256, 4, 4], [1024, 128, 8, 0], [16, 2, 8, 0]]",11332
13,"[[32, 16, 64, 2], [4, 256, 4, 4], [1024, 128, 8, 0], [16, 2, 8, 0]]",11332,up,16,"[[32, 16, 64, 2], [4, 256, 4, 4], [1024, 128, 16, 0], [16, 2, 4, 0]]",11348
13,"[[32, 16, 64, 2], [4, 256, 4, 4], [1024, 128, 16, 0], [16, 2, 4, 0]]",11348,left,8,"[[32, 16, 64, 2], [4, 256, 8, 0], [1024, 128, 16, 4], [16, 2, 4, 0]]",11356
13,"[[32, 16, 64, 2], [4, 256, 8, 0], [1024, 128, 16, 4], [16, 2, 4, 0]]",11356,right,0,"[[32, 16, 64, 2], [0, 4, 256, 8], [1024, 128, 16, 4], [4, 16, 2, 4]]",11356
13,"[[32, 16, 64, 2], [0, 4, 256, 8], [1024, 128, 16, 4], [4, 16, 2, 4]]",11356,up,8,"[[32, 16, 64, 2], [1024, 4, 256, 8], [4, 128, 16, 8], [0, 16, 2, 4]]",11364
13,"[[32, 16, 64, 2], [1024, 4, 256, 8], [4, 128, 16, 8], [0, 16, 2, 4]]",11364,down,16,"[[2, 16, 64, 0], [32, 4, 256, 2], [1024, 128, 16, 16], [4, 16, 2, 4]]",11380
13,"[[2, 16, 64, 0], [32, 4, 256, 2], [1024, 128, 16, 16], [4, 16, 2, 4]]",11380,left,32,"[[2, 16, 64, 2], [32, 4, 256, 2], [1024, 128, 32, 0], [4, 16, 2, 4]]",11412
13,"[[2, 16, 64, 2], [32, 4, 256, 2], [1024, 128, 32, 0], [4, 16, 2, 4]]",11412,up,4,"[[2, 16, 64, 4], [32, 4, 256, 4], [1024, 128, 32, 4], [4, 16, 2, 0]]",11416
13,"[[2, 16, 64, 4], [32, 4, 256, 4], [1024, 128, 32, 4], [4, 16, 2, 0]]",11416,left,0,"[[2, 16, 64, 4], [32, 4, 256, 4], [1024, 128, 32, 4], [4, 16, 2, 2]]",11416
13,"[[2, 16, 64, 4], [32, 4, 256, 4], [1024, 128, 32, 4], [4, 16, 2, 2]]",11416,right,4,"[[2, 16, 64, 4], [32, 4, 256, 4], [1024, 128, 32, 4], [2, 4, 16, 4]]",11420
13,"[[2, 16, 64, 4], [32, 4, 256, 4], [1024, 128, 32, 4], [2, 4, 16, 4]]",11420,down,16,"[[2, 16, 64, 0], [32, 4, 256, 4], [1024, 128, 32, 8], [2, 4, 16, 8]]",11436
13,"[[2, 16, 64, 0], [32, 4, 256, 4], [1024, 128, 32, 8], [2, 4, 16, 8]]",11436,down,16,"[[2, 16, 64, 0], [32, 4, 256, 4], [1024, 128, 32, 4], [2, 4, 16, 16]]",11452
13,"[[2, 16, 64, 0], [32, 4, 256, 4], [1024, 128, 32, 4], [2, 4, 16, 16]]",11452,right,32,"[[0, 2, 16, 64], [32, 4, 256, 4], [1024, 128, 32, 4], [2, 2, 4, 32]]",11484
13,"[[0, 2, 16, 64], [32, 4, 256, 4], [1024, 128, 32, 4], [2, 2, 4, 32]]",11484,left,4,"[[2, 16, 64, 0], [32, 4, 256, 4], [1024, 128, 32, 4], [4, 4, 32, 2]]",11488
13,"[[2, 16, 64, 0], [32, 4, 256, 4], [1024, 128, 32, 4], [4, 4, 32, 2]]",11488,up,72,"[[2, 16, 64, 8], [32, 4, 256, 2], [1024, 128, 64, 2], [4, 4, 0, 0]]",11560
13,"[[2, 16, 64, 8], [32, 4, 256, 2], [1024, 128, 64, 2], [4, 4, 0, 0]]",11560,up,4,"[[2, 16, 64, 8], [32, 4, 256, 4], [1024, 128, 64, 0], [4, 4, 2, 0]]",11564
13,"[[2, 16, 64, 8], [32, 4, 256, 4], [1024, 128, 64, 0], [4, 4, 2, 0]]",11564,left,8,"[[2, 16, 64, 8], [32, 4, 256, 4], [1024, 128, 64, 0], [8, 2, 0, 2]]",11572
13,"[[2, 16, 64, 8], [32, 4, 256, 4], [1024, 128, 64, 0], [8, 2, 0, 2]]",11572,left,4,"[[2, 16, 64, 8], [32, 4, 256, 4], [1024, 128, 64, 0], [8, 4, 0, 2]]",11576
13,"[[2, 16, 64, 8], [32, 4, 256, 4], [1024, 128, 64, 0], [8, 4, 0, 2]]",11576,up,0,"[[2, 16, 64, 8], [32, 4, 256, 4], [1024, 128, 64, 2], [8, 4, 4, 0]]",11576
13,"[[2, 16, 64, 8], [32, 4, 256, 4], [1024, 128, 64, 2], [8, 4, 4, 0]]",11576,left,8,"[[2, 16, 64, 8], [32, 4, 256, 4], [1024, 128, 64, 2], [8, 8, 0, 2]]",11584
13,"[[2, 16, 64, 8], [32, 4, 256, 4], [1024, 128, 64, 2], [8, 8, 0, 2]]",11584,up,4,"[[2, 16, 64, 8], [32, 4, 256, 4], [1024, 128, 64, 4], [8, 8, 2, 0]]",11588
13,"[[2, 16, 64, 8], [32, 4, 256, 4], [1024, 128, 64, 4], [8, 8, 2, 0]]",11588,up,8,"[[2, 16, 64, 8], [32, 4, 256, 8], [1024, 128, 64, 0], [8, 8, 2, 4]]",11596
13,"[[2, 16, 64, 8], [32, 4, 256, 8], [1024, 128, 64, 0], [8, 8, 2, 4]]",11596,up,16,"[[2, 16, 64, 16], [32, 4, 256, 4], [1024, 128, 64, 0], [8, 8, 2, 4]]",11612
13,"[[2, 16, 64, 16], [32, 4, 256, 4], [1024, 128, 64, 0], [8, 8, 2, 4]]",11612,up,8,"[[2, 16, 64, 16], [32, 4, 256, 8], [1024, 128, 64, 4], [8, 8, 2, 0]]",11620
13,"[[2, 16, 64, 16], [32, 4, 256, 8], [1024, 128, 64, 4], [8, 8, 2, 0]]",11620,left,16,"[[2, 16, 64, 16], [32, 4, 256, 8], [1024, 128, 64, 4], [16, 2, 4, 0]]",11636
13,"[[2, 16, 64, 16], [32, 4, 256, 8], [1024, 128, 64, 4], [16, 2, 4, 0]]",11636,right,0,"[[2, 16, 64, 16], [32, 4, 256, 8], [1024, 128, 64, 4], [2, 16, 2, 4]]",11636
13,"[[2, 16, 64, 16], [32, 4, 256, 8], [1024, 128, 64, 4], [2, 16, 2, 4]]",11636,up,8,"[[2, 16, 64, 16], [32, 4, 256, 8], [1024, 128, 64, 8], [2, 16, 2, 2]]",11644
13,"[[2, 16, 64, 16], [32, 4, 256, 8], [1024, 128, 64, 8], [2, 16, 2, 2]]",11644,down,16,"[[2, 16, 64, 2], [32, 4, 256, 16], [1024, 128, 64, 16], [2, 16, 2, 2]]",11660
13,"[[2, 16, 64, 2], [32, 4, 256, 16], [1024, 128, 64, 16], [2, 16, 2, 2]]",11660,down,32,"[[2, 16, 64, 2], [32, 4, 256, 2], [1024, 128, 64, 32], [2, 16, 2, 2]]",11692
13,"[[2, 16, 64, 2], [32, 4, 256, 2], [1024, 128, 64, 32], [2, 16, 2, 2]]",11692,left,4,"[[2, 16, 64, 2], [32, 4, 256, 2], [1024, 128, 64, 32], [2, 16, 4, 4]]",11696
13,"[[2, 16, 64, 2], [32, 4, 256, 2], [1024, 128, 64, 32], [2, 16, 4, 4]]",11696,right,8,"[[2, 16, 64, 2], [32, 4, 256, 2], [1024, 128, 64, 32], [2, 2, 16, 8]]",11704
13,"[[2, 16, 64, 2], [32, 4, 256, 2], [1024, 128, 64, 32], [2, 2, 16, 8]]",11704,right,4,"[[2, 16, 64, 2], [32, 4, 256, 2], [1024, 128, 64, 32], [4, 4, 16, 8]]",11708
13,"[[2, 16, 64, 2], [32, 4, 256, 2], [1024, 128, 64, 32], [4, 4, 16, 8]]",11708,left,8,"[[2, 16, 64, 2], [32, 4, 256, 2], [1024, 128, 64, 32], [8, 16, 8, 4]]",11716
13,"[[2, 16, 64, 2], [32, 4, 256, 2], [1024, 128, 64, 32], [8, 16, 8, 4]]",11716,up,4,"[[2, 16, 64, 4], [32, 4, 256, 32], [1024, 128, 64, 4], [8, 16, 8, 4]]",11720
13,"[[2, 16, 64, 4], [32, 4, 256, 32], [1024, 128, 64, 4], [8, 16, 8, 4]]",11720,down,8,"[[2, 16, 64, 4], [32, 4, 256, 4], [1024, 128, 64, 32], [8, 16, 8, 8]]",11728
13,"[[2, 16, 64, 4], [32, 4, 256, 4], [1024, 128, 64, 32], [8, 16, 8, 8]]",11728,right,16,"[[2, 16, 64, 4], [32, 4, 256, 4], [1024, 128, 64, 32], [4, 8, 16, 16]]",11744
13,"[[2, 16, 64, 4], [32, 4, 256, 4], [1024, 128, 64, 32], [4, 8, 16, 16]]",11744,right,32,"[[2, 16, 64, 4], [32, 4, 256, 4], [1024, 128, 64, 32], [2, 4, 8, 32]]",11776
13,"[[2, 16, 64, 4], [32, 4, 256, 4], [1024, 128, 64, 32], [2, 4, 8, 32]]",11776,down,72,"[[2, 16, 64, 2], [32, 4, 256, 0], [1024, 128, 64, 8], [2, 4, 8, 64]]",11848
13,"[[2, 16, 64, 2], [32, 4, 256, 0], [1024, 128, 64, 8], [2, 4, 8, 64]]",11848,up,0,"[[2, 16, 64, 2], [32, 4, 256, 8], [1024, 128, 64, 64], [2, 4, 8, 4]]",11848
13,"[[2, 16, 64, 2], [32, 4, 256, 8], [1024, 128, 64, 64], [2, 4, 8, 4]]",11848,right,128,"[[2, 16, 64, 2], [32, 4, 256, 8], [4, 1024, 128, 128], [2, 4, 8, 4]]",11976
13,"[[2, 16, 64, 2], [32, 4, 256, 8], [4, 1024, 128, 128], [2, 4, 8, 4]]",11976,left,256,"[[2, 16, 64, 2], [32, 4, 256, 8], [4, 1024, 256, 2], [2, 4, 8, 4]]",12232
13,"[[2, 16, 64, 2], [32, 4, 256, 8], [4, 1024, 256, 2], [2, 4, 8, 4]]",12232,up,512,"[[2, 16, 64, 2], [32, 4, 512, 8], [4, 1024, 8, 2], [2, 4, 4, 4]]",12744
13,"[[2, 16, 64, 2], [32, 4, 512, 8], [4, 1024, 8, 2], [2, 4, 4, 4]]",12744,left,8,"[[2, 16, 64, 2], [32, 4, 512, 8], [4, 1024, 8, 2], [2, 8, 4, 4]]",12752
13,"[[2, 16, 64, 2], [32, 4, 512, 8], [4, 1024, 8, 2], [2, 8, 4, 4]]",12752,left,8,"[[2, 16, 64, 2], [32, 4, 512, 8], [4, 1024, 8, 2], [2, 8, 8, 4]]",12760
13,"[[2, 16, 64, 2], [32, 4, 512, 8], [4, 1024, 8, 2], [2, 8, 8, 4]]",12760,left,16,"[[2, 16, 64, 2], [32, 4, 512, 8], [4, 1024, 8, 2], [2, 16, 4, 4]]",12776
13,"[[2, 16, 64, 2], [32, 4, 512, 8], [4, 1024, 8, 2], [2, 16, 4, 4]]",12776,left,8,"[[2, 16, 64, 2], [32, 4, 512, 8], [4, 1024, 8, 2], [2, 16, 8, 4]]",12784
13,"[[2, 16, 64, 2], [32, 4, 512, 8], [4, 1024, 8, 2], [2, 16, 8, 4]]",12784,down,16,"[[2, 16, 2, 2], [32, 4, 64, 8], [4, 1024, 512, 2], [2, 16, 16, 4]]",12800
13,"[[2, 16, 2, 2], [32, 4, 64, 8], [4, 1024, 512, 2], [2, 16, 16, 4]]",12800,right,36,"[[0, 2, 16, 4], [32, 4, 64, 8], [4, 1024, 512, 2], [2, 2, 32, 4]]",12836
13,"[[0, 2, 16, 4], [32, 4, 64, 8], [4, 1024, 512, 2], [2, 2, 32, 4]]",12836,left,4,"[[2, 16, 4, 4], [32, 4, 64, 8], [4, 1024, 512, 2], [4, 32, 4, 0]]",12840
13,"[[2, 16, 4, 4], [32, 4, 64, 8], [4, 1024, 512, 2], [4, 32, 4, 0]]",12840,right,8,"[[4, 2, 16, 8], [32, 4, 64, 8], [4, 1024, 512, 2], [0, 4, 32, 4]]",12848
13,"[[4, 2, 16, 8], [32, 4, 64, 8], [4, 1024, 512, 2], [0, 4, 32, 4]]",12848,up,16,"[[4, 2, 16, 16], [32, 4, 64, 2], [4, 1024, 512, 4], [4, 4, 32, 0]]",12864
13,"[[4, 2, 16, 16], [32, 4, 64, 2], [4, 1024, 512, 4], [4, 4, 32, 0]]",12864,right,40,"[[0, 4, 2, 32], [32, 4, 64, 2], [4, 1024, 512, 4], [0, 2, 8, 32]]",12904
13,"[[0, 4, 2, 32], [32, 4, 64, 2], [4, 1024, 512, 4], [0, 2, 8, 32]]",12904,up,8,"[[32, 8, 2, 32], [4, 1024, 64, 2], [0, 2, 512, 4], [0, 4, 8, 32]]",12912
13,"[[32, 8, 2, 32], [4, 1024, 64, 2], [0, 2, 512, 4], [0, 4, 8, 32]]",12912,up,0,"[[32, 8, 2, 32], [4, 1024, 64, 2], [0, 2, 512, 4], [4, 4, 8, 32]]",12912
13,"[[32, 8, 2, 32], [4, 1024, 64, 2], [0, 2, 512, 4], [4, 4, 8, 32]]",12912,right,8,"[[32, 8, 2, 32], [4, 1024, 64, 2], [0, 2, 512, 4], [2, 8, 8, 32]]",12920
13,"[[32, 8, 2, 32], [4, 1024, 64, 2], [0, 2, 512, 4], [2, 8, 8, 32]]",12920,left,16,"[[32, 8, 2, 32], [4, 1024, 64, 2], [2, 512, 4, 2], [2, 16, 32, 0]]",12936
13,"[[32, 8, 2, 32], [4, 1024, 64, 2], [2, 512, 4, 2], [2, 16, 32, 0]]",12936,down,8,"[[0, 8, 2, 0], [32, 1024, 64, 4], [4, 512, 4, 32], [4, 16, 32, 4]]",12944
13,"[[0, 8, 2, 0], [32, 1024, 64, 4], [4, 512, 4, 32], [4, 16, 32, 4]]",12944,up,8,"[[32, 8, 2, 4], [8, 1024, 64, 32], [0, 512, 4, 4], [0, 16, 32, 2]]",12952
13,"[[32, 8, 2, 4], [8, 1024, 64, 32], [0, 512, 4, 4], [0, 16, 32, 2]]",12952,left,8,"[[32, 8, 2, 4], [8, 1024, 64, 32], [512, 8, 0, 0], [16, 32, 2, 2]]",12960
13,"[[32, 8, 2, 4], [8, 1024, 64, 32], [512, 8, 0, 0], [16, 32, 2, 2]]",12960,left,4,"[[32, 8, 2, 4], [8, 1024, 64, 32], [512, 8, 0, 4], [16, 32, 4, 0]]",12964
13,"[[32, 8, 2, 4], [8, 1024, 64, 32], [512, 8, 0, 4], [16, 32, 4, 0]]",12964,up,0,"[[32, 8, 2, 4], [8, 1024, 64, 32], [512, 8, 4, 4], [16, 32, 0, 2]]",12964
13,"[[32, 8, 2, 4], [8, 1024, 64, 32], [512, 8, 4, 4], [16, 32, 0, 2]]",12964,left,8,"[[32, 8, 2, 4], [8, 1024, 64, 32], [512, 8, 8, 2], [16, 32, 2, 0]]",12972
13,"[[32, 8, 2, 4], [8, 1024, 64, 32], [512, 8, 8, 2], [16, 32, 2, 0]]",12972,down,0,"[[32, 8, 2, 4], [8, 1024, 64, 4], [512, 8, 8, 32], [16, 32, 2, 2]]",12972
13,"[[32, 8, 2, 4], [8, 1024, 64, 4], [512, 8, 8, 32], [16, 32, 2, 2]]",12972,left,20,"[[32, 8, 2, 4], [8, 1024, 64, 4], [512, 16, 32, 4], [16, 32, 4, 0]]",12992
13,"[[32, 8, 2, 4], [8, 1024, 64, 4], [512, 16, 32, 4], [16, 32, 4, 0]]",12992,right,0,"[[32, 8, 2, 4], [8, 1024, 64, 4], [512, 16, 32, 4], [4, 16, 32, 4]]",12992
13,"[[32, 8, 2, 4], [8, 1024, 64, 4], [512, 16, 32, 4], [4, 16, 32, 4]]",12992,down,112,"[[32, 2, 0, 0], [8, 8, 2, 0], [512, 1024, 64, 8], [4, 32, 64, 8]]",13104
13,"[[32, 2, 0, 0], [8, 8, 2, 0], [512, 1024, 64, 8], [4, 32, 64, 8]]",13104,up,144,"[[32, 2, 2, 16], [8, 8, 128, 0], [512, 1024, 0, 4], [4, 32, 0, 0]]",13248
13,"[[32, 2, 2, 16], [8, 8, 128, 0], [512, 1024, 0, 4], [4, 32, 0, 0]]",13248,right,20,"[[0, 32, 4, 16], [0, 0, 16, 128], [2, 512, 1024, 4], [0, 0, 4, 32]]",13268
13,"[[0, 32, 4, 16], [0, 0, 16, 128], [2, 512, 1024, 4], [0, 0, 4, 32]]",13268,down,0,"[[0, 2, 4, 16], [0, 0, 16, 128], [0, 32, 1024, 4], [2, 512, 4, 32]]",13268
13,"[[0, 2, 4, 16], [0, 0, 16, 128], [0, 32, 1024, 4], [2, 512, 4, 32]]",13268,down,0,"[[0, 0, 4, 16], [0, 2, 16, 128], [2, 32, 1024, 4], [2, 512, 4, 32]]",13268
13,"[[0, 0, 4, 16], [0, 2, 16, 128], [2, 32, 1024, 4], [2, 512, 4, 32]]",13268,left,0,"[[4, 16, 4, 0], [2, 16, 128, 0], [2, 32, 1024, 4], [2, 512, 4, 32]]",13268
13,"[[4, 16, 4, 0], [2, 16, 128, 0], [2, 32, 1024, 4], [2, 512, 4, 32]]",13268,up,36,"[[4, 32, 4, 4], [4, 32, 128, 32], [2, 512, 1024, 0], [0, 0, 4, 4]]",13304
13,"[[4, 32, 4, 4], [4, 32, 128, 32], [2, 512, 1024, 0], [0, 0, 4, 4]]",13304,down,72,"[[0, 0, 4, 0], [0, 2, 128, 4], [8, 64, 1024, 32], [2, 512, 4, 4]]",13376
13,"[[0, 0, 4, 0], [0, 2, 128, 4], [8, 64, 1024, 32], [2, 512, 4, 4]]",13376,right,8,"[[0, 0, 0, 4], [4, 2, 128, 4], [8, 64, 1024, 32], [0, 2, 512, 8]]",13384
13,"[[0, 0, 0, 4], [4, 2, 128, 4], [8, 64, 1024, 32], [0, 2, 512, 8]]",13384,down,8,"[[0, 2, 0, 0], [0, 2, 128, 8], [4, 64, 1024, 32], [8, 2, 512, 8]]",13392
13,"[[0, 2, 0, 0], [0, 2, 128, 8], [4, 64, 1024, 32], [8, 2, 512, 8]]",13392,up,4,"[[4, 4, 128, 8], [8, 64, 1024, 32], [0, 2, 512, 8], [4, 0, 0, 0]]",13396
13,"[[4, 4, 128, 8], [8, 64, 1024, 32], [0, 2, 512, 8], [4, 0, 0, 0]]",13396,left,8,"[[8, 128, 8, 0], [8, 64, 1024, 32], [2, 512, 8, 0], [4, 0, 0, 4]]",13404
13,"[[8, 128, 8, 0], [8, 64, 1024, 32], [2, 512, 8, 0], [4, 0, 0, 4]]",13404,up,16,"[[16, 128, 8, 32], [2, 64, 1024, 4], [4, 512, 8, 2], [0, 0, 0, 0]]",13420
13,"[[16, 128, 8, 32], [2, 64, 1024, 4], [4, 512, 8, 2], [0, 0, 0, 0]]",13420,right,0,"[[16, 128, 8, 32], [2, 64, 1024, 4], [4, 512, 8, 2], [0, 2, 0, 0]]",13420
13,"[[16, 128, 8, 32], [2, 64, 1024, 4], [4, 512, 8, 2], [0, 2, 0, 0]]",13420,right,0,"[[16, 128, 8, 32], [2, 64, 1024, 4], [4, 512, 8, 2], [0, 0, 4, 2]]",13420
13,"[[16, 128, 8, 32], [2, 64, 1024, 4], [4, 512, 8, 2], [0, 0, 4, 2]]",13420,up,4,"[[16, 128, 8, 32], [2, 64, 1024, 4], [4, 512, 8, 4], [2, 0, 4, 0]]",13424
13,"[[16, 128, 8, 32], [2, 64, 1024, 4], [4, 512, 8, 4], [2, 0, 4, 0]]",13424,up,8,"[[16, 128, 8, 32], [2, 64, 1024, 8], [4, 512, 8, 0], [2, 0, 4, 2]]",13432
13,"[[16, 128, 8, 32], [2, 64, 1024, 8], [4, 512, 8, 0], [2, 0, 4, 2]]",13432,right,0,"[[16, 128, 8, 32], [2, 64, 1024, 8], [2, 4, 512, 8], [0, 2, 4, 2]]",13432
13,"[[16, 128, 8, 32], [2, 64, 1024, 8], [2, 4, 512, 8], [0, 2, 4, 2]]",13432,up,20,"[[16, 128, 8, 32], [4, 64, 1024, 16], [0, 4, 512, 2], [0, 2, 4, 4]]",13452
13,"[[16, 128, 8, 32], [4, 64, 1024, 16], [0, 4, 512, 2], [0, 2, 4, 4]]",13452,left,8,"[[16, 128, 8, 32], [4, 64, 1024, 16], [4, 512, 2, 4], [2, 8, 0, 0]]",13460
13,"[[16, 128, 8, 32], [4, 64, 1024, 16], [4, 512, 2, 4], [2, 8, 0, 0]]",13460,right,0,"[[16, 128, 8, 32], [4, 64, 1024, 16], [4, 512, 2, 4], [0, 4, 2, 8]]",13460
13,"[[16, 128, 8, 32], [4, 64, 1024, 16], [4, 512, 2, 4], [0, 4, 2, 8]]",13460,up,12,"[[16, 128, 8, 32], [8, 64, 1024, 16], [0, 512, 4, 4], [2, 4, 0, 8]]",13472
13,"[[16, 128, 8, 32], [8, 64, 1024, 16], [0, 512, 4, 4], [2, 4, 0, 8]]",13472,right,8,"[[16, 128, 8, 32], [8, 64, 1024, 16], [4, 0, 512, 8], [0, 2, 4, 8]]",13480
13,"[[16, 128, 8, 32], [8, 64, 1024, 16], [4, 0, 512, 8], [0, 2, 4, 8]]",13480,up,16,"[[16, 128, 8, 32], [8, 64, 1024, 16], [4, 2, 512, 16], [0, 2, 4, 0]]",13496
13,"[[16, 128, 8, 32], [8, 64, 1024, 16], [4, 2, 512, 16], [0, 2, 4, 0]]",13496,up,36,"[[16, 128, 8, 32], [8, 64, 1024, 32], [4, 4, 512, 0], [0, 4, 4, 0]]",13532
13,"[[16, 128, 8, 32], [8, 64, 1024, 32], [4, 4, 512, 0], [0, 4, 4, 0]]",13532,up,72,"[[16, 128, 8, 64], [8, 64, 1024, 0], [4, 8, 512, 0], [0, 2, 4, 0]]",13604
13,"[[16, 128, 8, 64], [8, 64, 1024, 0], [4, 8, 512, 0], [0, 2, 4, 0]]",13604,down,0,"[[0, 128, 8, 2], [16, 64, 1024, 0], [8, 8, 512, 0], [4, 2, 4, 64]]",13604
13,"[[0, 128, 8, 2], [16, 64, 1024, 0], [8, 8, 512, 0], [4, 2, 4, 64]]",13604,left,16,"[[128, 8, 2, 0], [16, 64, 1024, 2], [16, 512, 0, 0], [4, 2, 4, 64]]",13620
13,"[[128, 8, 2, 0], [16, 64, 1024, 2], [16, 512, 0, 0], [4, 2, 4, 64]]",13620,up,32,"[[128, 8, 2, 2], [32, 64, 1024, 64], [4, 512, 4, 0], [0, 2, 0, 4]]",13652
13,"[[128, 8, 2, 2], [32, 64, 1024, 64], [4, 512, 4, 0], [0, 2, 0, 4]]",13652,down,0,"[[0, 8, 0, 4], [128, 64, 2, 2], [32, 512, 1024, 64], [4, 2, 4, 4]]",13652
13,"[[0, 8, 0, 4], [128, 64, 2, 2], [32, 512, 1024, 64], [4, 2, 4, 4]]",13652,down,0,"[[0, 8, 4, 4], [128, 64, 2, 2], [32, 512, 1024, 64], [4, 2, 4, 4]]",13652
13,"[[0, 8, 4, 4], [128, 64, 2, 2], [32, 512, 1024, 64], [4, 2, 4, 4]]",13652,right,20,"[[0, 0, 8, 8], [2, 128, 64, 4], [32, 512, 1024, 64], [0, 4, 2, 8]]",13672
13,"[[0, 0, 8, 8], [2, 128, 64, 4], [32, 512, 1024, 64], [0, 4, 2, 8]]",13672,left,16,"[[16, 4, 0, 0], [2, 128, 64, 4], [32, 512, 1024, 64], [4, 2, 8, 0]]",13688
13,"[[16, 4, 0, 0], [2, 128, 64, 4], [32, 512, 1024, 64], [4, 2, 8, 0]]",13688,right,0,"[[0, 2, 16, 4], [2, 128, 64, 4], [32, 512, 1024, 64], [0, 4, 2, 8]]",13688
13,"[[0, 2, 16, 4], [2, 128, 64, 4], [32, 512, 1024, 64], [0, 4, 2, 8]]",13688,up,8,"[[2, 2, 16, 8], [32, 128, 64, 64], [0, 512, 1024, 8], [2, 4, 2, 0]]",13696
13,"[[2, 2, 16, 8], [32, 128, 64, 64], [0, 512, 1024, 8], [2, 4, 2, 0]]",13696,left,132,"[[4, 16, 8, 0], [32, 128, 128, 0], [512, 1024, 8, 0], [2, 4, 2, 2]]",13828
13,"[[4, 16, 8, 0], [32, 128, 128, 0], [512, 1024, 8, 0], [2, 4, 2, 2]]",13828,left,260,"[[4, 16, 8, 0], [32, 256, 0, 0], [512, 1024, 8, 2], [2, 4, 4, 0]]",14088
13,"[[4, 16, 8, 0], [32, 256, 0, 0], [512, 1024, 8, 2], [2, 4, 4, 0]]",14088,up,16,"[[4, 16, 16, 2], [32, 256, 4, 0], [512, 1024, 0, 0], [2, 4, 0, 4]]",14104
13,"[[4, 16, 16, 2], [32, 256, 4, 0], [512, 1024, 0, 0], [2, 4, 0, 4]]",14104,right,40,"[[0, 4, 32, 2], [0, 32, 256, 4], [2, 0, 512, 1024], [0, 0, 2, 8]]",14144
13,"[[0, 4, 32, 2], [0, 32, 256, 4], [2, 0, 512, 1024], [0, 0, 2, 8]]",14144,left,0,"[[4, 32, 2, 4], [32, 256, 4, 0], [2, 512, 1024, 0], [2, 8, 0, 0]]",14144
13,"[[4, 32, 2, 4], [32, 256, 4, 0], [2, 512, 1024, 0], [2, 8, 0, 0]]",14144,right,0,"[[4, 32, 2, 4], [4, 32, 256, 4], [0, 2, 512, 1024], [0, 0, 2, 8]]",14144
13,"[[4, 32, 2, 4], [4, 32, 256, 4], [0, 2, 512, 1024], [0, 0, 2, 8]]",14144,down,80,"[[0, 0, 2, 0], [0, 0, 256, 8], [2, 64, 512, 1024], [8, 2, 2, 8]]",14224
13,"[[0, 0, 2, 0], [0, 0, 256, 8], [2, 64, 512, 1024], [8, 2, 2, 8]]",14224,left,4,"[[2, 0, 0, 4], [256, 8, 0, 0], [2, 64, 512, 1024], [8, 4, 8, 0]]",14228
13,"[[2, 0, 0, 4], [256, 8, 0, 0], [2, 64, 512, 1024], [8, 4, 8, 0]]",14228,up,0,"[[2, 8, 512, 4], [256, 64, 8, 1024], [2, 4, 0, 0], [8, 0, 0, 2]]",14228
13,"[[2, 8, 512, 4], [256, 64, 8, 1024], [2, 4, 0, 0], [8, 0, 0, 2]]",14228,up,0,"[[2, 8, 512, 4], [256, 64, 8, 1024], [2, 4, 0, 2], [8, 0, 4, 0]]",14228
13,"[[2, 8, 512, 4], [256, 64, 8, 1024], [2, 4, 0, 2], [8, 0, 4, 0]]",14228,up,0,"[[2, 8, 512, 4], [256, 64, 8, 1024], [2, 4, 4, 2], [8, 0, 0, 2]]",14228
13,"[[2, 8, 512, 4], [256, 64, 8, 1024], [2, 4, 4, 2], [8, 0, 0, 2]]",14228,right,8,"[[2, 8, 512, 4], [256, 64, 8, 1024], [0, 2, 8, 2], [0, 2, 8, 2]]",14236
13,"[[2, 8, 512, 4], [256, 64, 8, 1024], [0, 2, 8, 2], [0, 2, 8, 2]]",14236,down,24,"[[0, 2, 0, 0], [0, 8, 512, 4], [2, 64, 8, 1024], [256, 4, 16, 4]]",14260
13,"[[0, 2, 0, 0], [0, 8, 512, 4], [2, 64, 8, 1024], [256, 4, 16, 4]]",14260,up,0,"[[2, 2, 512, 4], [256, 8, 8, 1024], [0, 64, 16, 4], [2, 4, 0, 0]]",14260
13,"[[2, 2, 512, 4], [256, 8, 8, 1024], [0, 64, 16, 4], [2, 4, 0, 0]]",14260,left,20,"[[4, 512, 4, 0], [256, 16, 1024, 4], [64, 16, 4, 0], [2, 4, 0, 0]]",14280
13,"[[4, 512, 4, 0], [256, 16, 1024, 4], [64, 16, 4, 0], [2, 4, 0, 0]]",14280,up,32,"[[4, 512, 4, 4], [256, 32, 1024, 0], [64, 4, 4, 0], [2, 4, 0, 0]]",14312
13,"[[4, 512, 4, 4], [256, 32, 1024, 0], [64, 4, 4, 0], [2, 4, 0, 0]]",14312,down,8,"[[4, 0, 0, 0], [256, 512, 4, 2], [64, 32, 1024, 0], [2, 8, 4, 4]]",14320
13,"[[4, 0, 0, 0], [256, 512, 4, 2], [64, 32, 1024, 0], [2, 8, 4, 4]]",14320,left,8,"[[4, 2, 0, 0], [256, 512, 4, 2], [64, 32, 1024, 0], [2, 8, 8, 0]]",14328
13,"[[4, 2, 0, 0], [256, 512, 4, 2], [64, 32, 1024, 0], [2, 8, 8, 0]]",14328,right,16,"[[0, 0, 4, 2], [256, 512, 4, 2], [0, 64, 32, 1024], [4, 0, 2, 16]]",14344
13,"[[0, 0, 4, 2], [256, 512, 4, 2], [0, 64, 32, 1024], [4, 0, 2, 16]]",14344,down,12,"[[0, 0, 0, 0], [4, 0, 8, 4], [256, 512, 32, 1024], [4, 64, 2, 16]]",14356
13,"[[0, 0, 0, 0], [4, 0, 8, 4], [256, 512, 32, 1024], [4, 64, 2, 16]]",14356,down,0,"[[0, 0, 0, 0], [4, 2, 8, 4], [256, 512, 32, 1024], [4, 64, 2, 16]]",14356
13,"[[0, 0, 0, 0], [4, 2, 8, 4], [256, 512, 32, 1024], [4, 64, 2, 16]]",14356,left,0,"[[0, 0, 4, 0], [4, 2, 8, 4], [256, 512, 32, 1024], [4, 64, 2, 16]]",14356
13,"[[0, 0, 4, 0], [4, 2, 8, 4], [256, 512, 32, 1024], [4, 64, 2, 16]]",14356,right,0,"[[0, 0, 4, 4], [4, 2, 8, 4], [256, 512, 32, 1024], [4, 64, 2, 16]]",14356
13,"[[0, 0, 4, 4], [4, 2, 8, 4], [256, 512, 32, 1024], [4, 64, 2, 16]]",14356,down,8,"[[0, 2, 4, 0], [4, 2, 8, 8], [256, 512, 32, 1024], [4, 64, 2, 16]]",14364
13,"[[0, 2, 4, 0], [4, 2, 8, 8], [256, 512, 32, 1024], [4, 64, 2, 16]]",14364,down,4,"[[0, 0, 4, 2], [4, 4, 8, 8], [256, 512, 32, 1024], [4, 64, 2, 16]]",14368
13,"[[0, 0, 4, 2], [4, 4, 8, 8], [256, 512, 32, 1024], [4, 64, 2, 16]]",14368,right,24,"[[0, 2, 4, 2], [0, 0, 8, 16], [256, 512, 32, 1024], [4, 64, 2, 16]]",14392
13,"[[0, 2, 4, 2], [0, 0, 8, 16], [256, 512, 32, 1024], [4, 64, 2, 16]]",14392,down,0,"[[4, 0, 4, 2], [0, 2, 8, 16], [256, 512, 32, 1024], [4, 64, 2, 16]]",14392
13,"[[4, 0, 4, 2], [0, 2, 8, 16], [256, 512, 32, 1024], [4, 64, 2, 16]]",14392,right,8,"[[0, 4, 8, 2], [0, 2, 8, 16], [256, 512, 32, 1024], [4, 64, 2, 16]]",14400
13,"[[0, 4, 8, 2], [0, 2, 8, 16], [256, 512, 32, 1024], [4, 64, 2, 16]]",14400,down,16,"[[0, 4, 4, 2], [0, 2, 16, 16], [256, 512, 32, 1024], [4, 64, 2, 16]]",14416
13,"[[0, 4, 4, 2], [0, 2, 16, 16], [256, 512, 32, 1024], [4, 64, 2, 16]]",14416,left,40,"[[8, 2, 2, 0], [2, 32, 0, 0], [256, 512, 32, 1024], [4, 64, 2, 16]]",14456
13,"[[8, 2, 2, 0], [2, 32, 0, 0], [256, 512, 32, 1024], [4, 64, 2, 16]]",14456,up,0,"[[8, 2, 2, 1024], [2, 32, 32, 16], [256, 512, 2, 0], [4, 64, 0, 2]]",14456
13,"[[8, 2, 2, 1024], [2, 32, 32, 16], [256, 512, 2, 0], [4, 64, 0, 2]]",14456,left,68,"[[8, 4, 1024, 0], [2, 64, 16, 0], [256, 512, 2, 0], [4, 64, 2, 4]]",14524
13,"[[8, 4, 1024, 0], [2, 64, 16, 0], [256, 512, 2, 0], [4, 64, 2, 4]]",14524,down,4,"[[8, 4, 0, 0], [2, 64, 1024, 0], [256, 512, 16, 2], [4, 64, 4, 4]]",14528
13,"[[8, 4, 0, 0], [2, 64, 1024, 0], [256, 512, 16, 2], [4, 64, 4, 4]]",14528,left,8,"[[8, 4, 0, 0], [2, 64, 1024, 2], [256, 512, 16, 2], [4, 64, 8, 0]]",14536
13,"[[8, 4, 0, 0], [2, 64, 1024, 2], [256, 512, 16, 2], [4, 64, 8, 0]]",14536,right,0,"[[0, 2, 8, 4], [2, 64, 1024, 2], [256, 512, 16, 2], [0, 4, 64, 8]]",14536
13,"[[0, 2, 8, 4], [2, 64, 1024, 2], [256, 512, 16, 2], [0, 4, 64, 8]]",14536,up,4,"[[2, 2, 8, 4], [256, 64, 1024, 4], [0, 512, 16, 8], [0, 4, 64, 2]]",14540
13,"[[2, 2, 8, 4], [256, 64, 1024, 4], [0, 512, 16, 8], [0, 4, 64, 2]]",14540,down,8,"[[4, 2, 8, 0], [0, 64, 1024, 8], [2, 512, 16, 8], [256, 4, 64, 2]]",14548
13,"[[4, 2, 8, 0], [0, 64, 1024, 8], [2, 512, 16, 8], [256, 4, 64, 2]]",14548,down,16,"[[2, 2, 8, 0], [4, 64, 1024, 0], [2, 512, 16, 16], [256, 4, 64, 2]]",14564
13,"[[2, 2, 8, 0], [4, 64, 1024, 0], [2, 512, 16, 16], [256, 4, 64, 2]]",14564,left,36,"[[4, 8, 0, 0], [4, 64, 1024, 0], [2, 512, 32, 4], [256, 4, 64, 2]]",14600
13,"[[4, 8, 0, 0], [4, 64, 1024, 0], [2, 512, 32, 4], [256, 4, 64, 2]]",14600,up,8,"[[8, 8, 1024, 4], [2, 64, 32, 2], [256, 512, 64, 0], [0, 4, 0, 2]]",14608
13,"[[8, 8, 1024, 4], [2, 64, 32, 2], [256, 512, 64, 0], [0, 4, 0, 2]]",14608,up,4,"[[8, 8, 1024, 4], [2, 64, 32, 4], [256, 512, 64, 0], [4, 4, 0, 0]]",14612
13,"[[8, 8, 1024, 4], [2, 64, 32, 4], [256, 512, 64, 0], [4, 4, 0, 0]]",14612,up,8,"[[8, 8, 1024, 8], [2, 64, 32, 0], [256, 512, 64, 2], [4, 4, 0, 0]]",14620
13,"[[8, 8, 1024, 8], [2, 64, 32, 0], [256, 512, 64, 2], [4, 4, 0, 0]]",14620,right,24,"[[0, 16, 1024, 8], [4, 2, 64, 32], [256, 512, 64, 2], [0, 0, 0, 8]]",14644
13,"[[0, 16, 1024, 8], [4, 2, 64, 32], [256, 512, 64, 2], [0, 0, 0, 8]]",14644,down,128,"[[0, 0, 2, 8], [0, 16, 0, 32], [4, 2, 1024, 2], [256, 512, 128, 8]]",14772
13,"[[0, 0, 2, 8], [0, 16, 0, 32], [4, 2, 1024, 2], [256, 512, 128, 8]]",14772,right,0,"[[4, 0, 2, 8], [0, 0, 16, 32], [4, 2, 1024, 2], [256, 512, 128, 8]]",14772
13,"[[4, 0, 2, 8], [0, 0, 16, 32], [4, 2, 1024, 2], [256, 512, 128, 8]]",14772,up,8,"[[8, 2, 2, 8], [256, 512, 16, 32], [0, 2, 1024, 2], [0, 0, 128, 8]]",14780
13,"[[8, 2, 2, 8], [256, 512, 16, 32], [0, 2, 1024, 2], [0, 0, 128, 8]]",14780,right,4,"[[0, 8, 4, 8], [256, 512, 16, 32], [0, 2, 1024, 2], [0, 2, 128, 8]]",14784
13,"[[0, 8, 4, 8], [256, 512, 16, 32], [0, 2, 1024, 2], [0, 2, 128, 8]]",14784,up,4,"[[256, 8, 4, 8], [4, 512, 16, 32], [0, 4, 1024, 2], [0, 0, 128, 8]]",14788
13,"[[256, 8, 4, 8], [4, 512, 16, 32], [0, 4, 1024, 2], [0, 0, 128, 8]]",14788,down,0,"[[0, 0, 4, 8], [4, 8, 16, 32], [256, 512, 1024, 2], [4, 4, 128, 8]]",14788
13,"[[0, 0, 4, 8], [4, 8, 16, 32], [256, 512, 1024, 2], [4, 4, 128, 8]]",14788,left,8,"[[4, 8, 0, 0], [4, 8, 16, 32], [256, 512, 1024, 2], [8, 128, 8, 2]]",14796
13,"[[4, 8, 0, 0], [4, 8, 16, 32], [256, 512, 1024, 2], [8, 128, 8, 2]]",14796,up,28,"[[8, 16, 16, 32], [256, 512, 1024, 4], [8, 128, 8, 4], [0, 0, 0, 0]]",14824
13,"[[8, 16, 16, 32], [256, 512, 1024, 4], [8, 128, 8, 4], [0, 0, 0, 0]]",14824,left,32,"[[8, 32, 32, 0], [256, 512, 1024, 4], [8, 128, 8, 4], [0, 2, 0, 0]]",14856
13,"[[8, 32, 32, 0], [256, 512, 1024, 4], [8, 128, 8, 4], [0, 2, 0, 0]]",14856,left,64,"[[8, 64, 0, 0], [256, 512, 1024, 4], [8, 128, 8, 4], [2, 4, 0, 0]]",14920
13,"[[8, 64, 0, 0], [256, 512, 1024, 4], [8, 128, 8, 4], [2, 4, 0, 0]]",14920,down,8,"[[8, 64, 0, 0], [256, 512, 4, 0], [8, 128, 1024, 0], [2, 4, 8, 8]]",14928
13,"[[8, 64, 0, 0], [256, 512, 4, 0], [8, 128, 1024, 0], [2, 4, 8, 8]]",14928,right,16,"[[2, 0, 8, 64], [0, 256, 512, 4], [0, 8, 128, 1024], [0, 2, 4, 16]]",14944
13,"[[2, 0, 8, 64], [0, 256, 512, 4], [0, 8, 128, 1024], [0, 2, 4, 16]]",14944,down,0,"[[0, 0, 8, 64], [0, 256, 512, 4], [2, 8, 128, 1024], [2, 2, 4, 16]]",14944
13,"[[0, 0, 8, 64], [0, 256, 512, 4], [2, 8, 128, 1024], [2, 2, 4, 16]]",14944,left,4,"[[8, 64, 4, 0], [256, 512, 4, 0], [2, 8, 128, 1024], [4, 4, 16, 0]]",14948
13,"[[8, 64, 4, 0], [256, 512, 4, 0], [2, 8, 128, 1024], [4, 4, 16, 0]]",14948,right,8,"[[0, 8, 64, 4], [0, 256, 512, 4], [2, 8, 128, 1024], [2, 0, 8, 16]]",14956
13,"[[0, 8, 64, 4], [0, 256, 512, 4], [2, 8, 128, 1024], [2, 0, 8, 16]]",14956,down,12,"[[0, 0, 64, 2], [0, 8, 512, 8], [0, 256, 128, 1024], [4, 8, 8, 16]]",14968
13,"[[0, 0, 64, 2], [0, 8, 512, 8], [0, 256, 128, 1024], [4, 8, 8, 16]]",14968,right,16,"[[0, 0, 64, 2], [0, 8, 512, 8], [2, 256, 128, 1024], [0, 4, 16, 16]]",14984
13,"[[0, 0, 64, 2], [0, 8, 512, 8], [2, 256, 128, 1024], [0, 4, 16, 16]]",14984,right,32,"[[4, 0, 64, 2], [0, 8, 512, 8], [2, 256, 128, 1024], [0, 0, 4, 32]]",15016
13,"[[4, 0, 64, 2], [0, 8, 512, 8], [2, 256, 128, 1024], [0, 0, 4, 32]]",15016,right,0,"[[0, 4, 64, 2], [0, 8, 512, 8], [2, 256, 128, 1024], [2, 0, 4, 32]]",15016
13,"[[0, 4, 64, 2], [0, 8, 512, 8], [2, 256, 128, 1024], [2, 0, 4, 32]]",15016,up,4,"[[4, 4, 64, 2], [0, 8, 512, 8], [0, 256, 128, 1024], [2, 0, 4, 32]]",15020
13,"[[4, 4, 64, 2], [0, 8, 512, 8], [0, 256, 128, 1024], [2, 0, 4, 32]]",15020,right,8,"[[0, 8, 64, 2], [0, 8, 512, 8], [0, 256, 128, 1024], [4, 2, 4, 32]]",15028
13,"[[0, 8, 64, 2], [0, 8, 512, 8], [0, 256, 128, 1024], [4, 2, 4, 32]]",15028,up,16,"[[4, 16, 64, 2], [2, 256, 512, 8], [0, 2, 128, 1024], [0, 0, 4, 32]]",15044
13,"[[4, 16, 64, 2], [2, 256, 512, 8], [0, 2, 128, 1024], [0, 0, 4, 32]]",15044,down,0,"[[0, 2, 64, 2], [0, 16, 512, 8], [4, 256, 128, 1024], [2, 2, 4, 32]]",15044
13,"[[0, 2, 64, 2], [0, 16, 512, 8], [4, 256, 128, 1024], [2, 2, 4, 32]]",15044,right,4,"[[0, 2, 64, 2], [2, 16, 512, 8], [4, 256, 128, 1024], [0, 4, 4, 32]]",15048
13,"[[0, 2, 64, 2], [2, 16, 512, 8], [4, 256, 128, 1024], [0, 4, 4, 32]]",15048,left,8,"[[2, 64, 2, 0], [2, 16, 512, 8], [4, 256, 128, 1024], [8, 32, 2, 0]]",15056
13,"[[2, 64, 2, 0], [2, 16, 512, 8], [4, 256, 128, 1024], [8, 32, 2, 0]]",15056,up,4,"[[4, 64, 2, 8], [4, 16, 512, 1024], [8, 256, 128, 0], [2, 32, 2, 0]]",15060
13,"[[4, 64, 2, 8], [4, 16, 512, 1024], [8, 256, 128, 0], [2, 32, 2, 0]]",15060,up,8,"[[8, 64, 2, 8], [8, 16, 512, 1024], [2, 256, 128, 0], [4, 32, 2, 0]]",15068
13,"[[8, 64, 2, 8], [8, 16, 512, 1024], [2, 256, 128, 0], [4, 32, 2, 0]]",15068,down,16,"[[0, 64, 2, 4], [16, 16, 512, 0], [2, 256, 128, 8], [4, 32, 2, 1024]]",15084
13,"[[0, 64, 2, 4], [16, 16, 512, 0], [2, 256, 128, 8], [4, 32, 2, 1024]]",15084,left,32,"[[64, 2, 4, 0], [32, 512, 2, 0], [2, 256, 128, 8], [4, 32, 2, 1024]]",15116
13,"[[64, 2, 4, 0], [32, 512, 2, 0], [2, 256, 128, 8], [4, 32, 2, 1024]]",15116,down,0,"[[64, 2, 4, 2], [32, 512, 2, 0], [2, 256, 128, 8], [4, 32, 2, 1024]]",15116
13,"[[64, 2, 4, 2], [32, 512, 2, 0], [2, 256, 128, 8], [4, 32, 2, 1024]]",15116,right,0,"[[64, 2, 4, 2], [2, 32, 512, 2], [2, 256, 128, 8], [4, 32, 2, 1024]]",15116
13,"[[64, 2, 4, 2], [2, 32, 512, 2], [2, 256, 128, 8], [4, 32, 2, 1024]]",15116,up,8,"[[64, 2, 4, 4], [4, 32, 512, 8], [4, 256, 128, 1024], [0, 32, 2, 4]]",15124
13,"[[64, 2, 4, 4], [4, 32, 512, 8], [4, 256, 128, 1024], [0, 32, 2, 4]]",15124,right,8,"[[2, 64, 2, 8], [4, 32, 512, 8], [4, 256, 128, 1024], [0, 32, 2, 4]]",15132
13,"[[2, 64, 2, 8], [4, 32, 512, 8], [4, 256, 128, 1024], [0, 32, 2, 4]]",15132,up,24,"[[2, 64, 2, 16], [8, 32, 512, 1024], [0, 256, 128, 4], [0, 32, 2, 4]]",15156
13,"[[2, 64, 2, 16], [8, 32, 512, 1024], [0, 256, 128, 4], [0, 32, 2, 4]]",15156,up,8,"[[2, 64, 2, 16], [8, 32, 512, 1024], [0, 256, 128, 8], [0, 32, 2, 2]]",15164
13,"[[2, 64, 2, 16], [8, 32, 512, 1024], [0, 256, 128, 8], [0, 32, 2, 2]]",15164,left,4,"[[2, 64, 2, 16], [8, 32, 512, 1024], [256, 128, 8, 4], [32, 4, 0, 0]]",15168
13,"[[2, 64, 2, 16], [8, 32, 512, 1024], [256, 128, 8, 4], [32, 4, 0, 0]]",15168,right,0,"[[2, 64, 2, 16], [8, 32, 512, 1024], [256, 128, 8, 4], [4, 0, 32, 4]]",15168
13,"[[2, 64, 2, 16], [8, 32, 512, 1024], [256, 128, 8, 4], [4, 0, 32, 4]]",15168,up,8,"[[2, 64, 2, 16], [8, 32, 512, 1024], [256, 128, 8, 8], [4, 4, 32, 0]]",15176
13,"[[2, 64, 2, 16], [8, 32, 512, 1024], [256, 128, 8, 8], [4, 4, 32, 0]]",15176,right,24,"[[2, 64, 2, 16], [8, 32, 512, 1024], [0, 256, 128, 16], [0, 4, 8, 32]]",15200
13,"[[2, 64, 2, 16], [8, 32, 512, 1024], [0, 256, 128, 16], [0, 4, 8, 32]]",15200,up,0,"[[2, 64, 2, 16], [8, 32, 512, 1024], [0, 256, 128, 16], [4, 4, 8, 32]]",15200
13,"[[2, 64, 2, 16], [8, 32, 512, 1024], [0, 256, 128, 16], [4, 4, 8, 32]]",15200,left,8,"[[2, 64, 2, 16], [8, 32, 512, 1024], [256, 128, 16, 2], [8, 8, 32, 0]]",15208
13,"[[2, 64, 2, 16], [8, 32, 512, 1024], [256, 128, 16, 2], [8, 8, 32, 0]]",15208,right,16,"[[2, 64, 2, 16], [8, 32, 512, 1024], [256, 128, 16, 2], [2, 0, 16, 32]]",15224
13,"[[2, 64, 2, 16], [8, 32, 512, 1024], [256, 128, 16, 2], [2, 0, 16, 32]]",15224,down,32,"[[2, 2, 0, 16], [8, 64, 2, 1024], [256, 32, 512, 2], [2, 128, 32, 32]]",15256
13,"[[2, 2, 0, 16], [8, 64, 2, 1024], [256, 32, 512, 2], [2, 128, 32, 32]]",15256,up,0,"[[2, 2, 2, 16], [8, 64, 512, 1024], [256, 32, 32, 2], [2, 128, 4, 32]]",15256
13,"[[2, 2, 2, 16], [8, 64, 512, 1024], [256, 32, 32, 2], [2, 128, 4, 32]]",15256,left,68,"[[4, 2, 16, 0], [8, 64, 512, 1024], [256, 64, 2, 2], [2, 128, 4, 32]]",15324
13,"[[4, 2, 16, 0], [8, 64, 512, 1024], [256, 64, 2, 2], [2, 128, 4, 32]]",15324,down,128,"[[4, 0, 16, 4], [8, 2, 512, 1024], [256, 128, 2, 2], [2, 128, 4, 32]]",15452
13,"[[4, 0, 16, 4], [8, 2, 512, 1024], [256, 128, 2, 2], [2, 128, 4, 32]]",15452,up,256,"[[4, 2, 16, 4], [8, 256, 512, 1024], [256, 4, 2, 2], [2, 0, 4, 32]]",15708
13,"[[4, 2, 16, 4], [8, 256, 512, 1024], [256, 4, 2, 2], [2, 0, 4, 32]]",15708,right,4,"[[4, 2, 16, 4], [8, 256, 512, 1024], [0, 256, 4, 4], [2, 2, 4, 32]]",15712
13,"[[4, 2, 16, 4], [8, 256, 512, 1024], [0, 256, 4, 4], [2, 2, 4, 32]]",15712,down,520,"[[0, 4, 0, 4], [4, 2, 16, 1024], [8, 512, 512, 4], [2, 2, 8, 32]]",16232
13,"[[0, 4, 0, 4], [4, 2, 16, 1024], [8, 512, 512, 4], [2, 2, 8, 32]]",16232,right,1036,"[[0, 4, 0, 8], [4, 2, 16, 1024], [0, 8, 1024, 4], [0, 4, 8, 32]]",17268
13,"[[0, 4, 0, 8], [4, 2, 16, 1024], [0, 8, 1024, 4], [0, 4, 8, 32]]",17268,up,0,"[[4, 4, 16, 8], [0, 2, 1024, 1024], [4, 8, 8, 4], [0, 4, 0, 32]]",17268
13,"[[4, 4, 16, 8], [0, 2, 1024, 1024], [4, 8, 8, 4], [0, 4, 0, 32]]",17268,left,2072,"[[8, 16, 8, 4], [2, 2048, 0, 0], [4, 16, 4, 0], [4, 32, 0, 0]]",19340
17,"[[0, 0, 2, 0], [0, 2, 0, 0], [0, 0, 0, 0], [0, 0, 0, 0]]",0,up,0,"[[0, 2, 2, 0], [0, 0, 0, 4], [0, 0, 0, 0], [0, 0, 0, 0]]",0
17,"[[0, 2, 2, 0], [0, 0, 0, 4], [0, 0, 0, 0], [0, 0, 0, 0]]",0,right,4,"[[4, 0, 0, 4], [0, 0, 0, 4], [0, 0, 0, 0], [0, 0, 0, 0]]",4
17,"[[4, 0, 0, 4], [0, 0, 0, 4], [0, 0, 0, 0], [0, 0, 0, 0]]",4,up,8,"[[4, 0, 0, 8], [0, 0, 0, 0], [0, 2, 0, 0], [0, 0, 0, 0]]",12
17,"[[4, 0, 0, 8], [0, 0, 0, 0], [0, 2, 0, 0], [0, 0, 0, 0]]",12,left,0,"[[4, 8, 2, 0], [0, 0, 0, 0], [2, 0, 0, 0], [0, 0, 0, 0]]",12
17,"[[4, 8, 2, 0], [0, 0, 0, 0], [2, 0, 0, 0], [0, 0, 0, 0]]",12,right,0,"[[0, 4, 8, 2], [0, 0, 0, 4], [0, 0, 0, 2], [0, 0, 0, 0]]",12
17,"[[0, 4, 8, 2], [0, 0, 0, 4], [0, 0, 0, 2], [0, 0, 0, 0]]",12,left,0,"[[4, 8, 2, 0], [4, 4, 0, 0], [2, 0, 0, 0], [0, 0, 0, 0]]",12
17,"[[4, 8, 2, 0], [4, 4, 0, 0], [2, 0, 0, 0], [0, 0, 0, 0]]",12,up,8,"[[8, 8, 2, 0], [2, 4, 4, 0], [0, 0, 0, 0], [0, 0, 0, 0]]",20
17,"[[8, 8, 2, 0], [2, 4, 4, 0], [0, 0, 0, 0], [0, 0, 0, 0]]",20,left,24,"[[16, 2, 0, 0], [2, 8, 0, 0], [0, 0, 0, 4], [0, 0, 0, 0]]",44
17,"[[16, 2, 0, 0], [2, 8, 0, 0], [0, 0, 0, 4], [0, 0, 0, 0]]",44,up,0,"[[16, 2, 0, 4], [2, 8, 2, 0], [0, 0, 0, 0], [0, 0, 0, 0]]",44
17,"[[16, 2, 0, 4], [2, 8, 2, 0], [0, 0, 0, 0], [0, 0, 0, 0]]",44,up,0,"[[16, 2, 2, 4], [2, 8, 0, 0], [0, 0, 0, 4], [0, 0, 0, 0]]",44
17,"[[16, 2, 2, 4], [2, 8, 0, 0], [0, 0, 0, 4], [0, 0, 0, 0]]",44,right,4,"[[0, 16, 4, 4], [0, 0, 2, 8], [0, 0, 4, 4], [0, 0, 0, 0]]",48
17,"[[0, 16, 4, 4], [0, 0, 2, 8], [0, 0, 4, 4], [0, 0, 0, 0]]",48,right,16,"[[0, 0, 16, 8], [0, 0, 2, 8], [0, 0, 0, 8], [0, 2, 0, 0]]",64
17,"[[0, 0, 16, 8], [0, 0, 2, 8], [0, 0, 0, 8], [0, 2, 0, 0]]",64,up,16,"[[0, 2, 16, 16], [0, 0, 2, 8], [2, 0, 0, 0], [0, 0, 0, 0]]",80
17,"[[0, 2, 16, 16], [0, 0, 2, 8], [2, 0, 0, 0], [0, 0, 0, 0]]",80,right,32,"[[0, 0, 2, 32], [0, 0, 2, 8], [0, 0, 4, 2], [0, 0, 0, 0]]",112
17,"[[0, 0, 2, 32], [0, 0, 2, 8], [0, 0, 4, 2], [0, 0, 0, 0]]",112,down,4,"[[0, 0, 0, 0], [0, 0, 4, 32], [0, 0, 4, 8], [0, 0, 4, 2]]",116
17,"[[0, 0, 0, 0], [0, 0, 4, 32], [0, 0, 4, 8], [0, 0, 4, 2]]",116,up,8,"[[0, 0, 8, 32], [0, 4, 4, 8], [0, 0, 0, 2], [0, 0, 0, 0]]",124
17,"[[0, 0, 8, 32], [0, 4, 4, 8], [0, 0, 0, 2], [0, 0, 0, 0]]",124,left,8,"[[8, 32, 0, 0], [8, 8, 2, 0], [2, 0, 0, 0], [0, 0, 0, 0]]",132
17,"[[8, 32, 0, 0], [8, 8, 2, 0], [2, 0, 0, 0], [0, 0, 0, 0]]",132,up,16,"[[16, 32, 2, 0], [2, 8, 4, 0], [0, 0, 0, 0], [0, 0, 0, 0]]",148
17,"[[16, 32, 2, 0], [2, 8, 4, 0], [0, 0, 0, 0], [0, 0, 0, 0]]",148,right,0,"[[4, 16, 32, 2], [0, 2, 8, 4], [0, 0, 0, 0], [0, 0, 0, 0]]",148
17,"[[4, 16, 32, 2], [0, 2, 8, 4], [0, 0, 0, 0], [0, 0, 0, 0]]",148,right,0,"[[4, 16, 32, 2], [0, 2, 8, 4], [0, 0, 0, 0], [0, 0, 0, 2]]",148
17,"[[4, 16, 32, 2], [0, 2, 8, 4], [0, 0, 0, 0], [0, 0, 0, 2]]",148,left,0,"[[4, 16, 32, 2], [2, 8, 4, 0], [0, 2, 0, 0], [2, 0, 0, 0]]",148
17,"[[4, 16, 32, 2], [2, 8, 4, 0], [0, 2, 0, 0], [2, 0, 0, 0]]",148,up,4,"[[4, 16, 32, 2], [4, 8, 4, 0], [0, 2, 2, 0], [0, 0, 0, 0]]",152
17,"[[4, 16, 32, 2], [4, 8, 4, 0], [0, 2, 2, 0], [0, 0, 0, 0]]",152,down,8,"[[4, 0, 0, 0], [0, 16, 32, 0], [0, 8, 4, 0], [8, 2, 2, 2]]",160
17,"[[4, 0, 0, 0], [0, 16, 32, 0], [0, 8, 4, 0], [8, 2, 2, 2]]",160,left,4,"[[4, 0, 0, 4], [16, 32, 0, 0], [8, 4, 0, 0], [8, 4, 2, 0]]",164
17,"[[4, 0, 0, 4], [16, 32, 0, 0], [8, 4, 0, 0], [8, 4, 2, 0]]",164,up,24,"[[4, 32, 2, 4], [16, 8, 0, 0], [16, 0, 0, 0], [0, 2, 0, 0]]",188
17,"[[4, 32, 2, 4], [16, 8, 0, 0], [16, 0, 0, 0], [0, 2, 0, 0]]",188,up,32,"[[4, 32, 2, 4], [32, 8, 0, 0], [0, 2, 0, 0], [0, 2, 0, 0]]",220
17,"[[4, 32, 2, 4], [32, 8, 0, 0], [0, 2, 0, 0], [0, 2, 0, 0]]",220,left,0,"[[4, 32, 2, 4], [32, 8, 0, 4], [2, 0, 0, 0], [2, 0, 0, 0]]",220
17,"[[4, 32, 2, 4], [32, 8, 0, 4], [2, 0, 0, 0], [2, 0, 0, 0]]",220,down,12,"[[0, 0, 2, 0], [4, 0, 0, 0], [32, 32, 0, 0], [4, 8, 2, 8]]",232
17,"[[0, 0, 2, 0], [4, 0, 0, 0], [32, 32, 0, 0], [4, 8, 2, 8]]",232,right,64,"[[0, 4, 0, 2], [0, 0, 0, 4], [0, 0, 0, 64], [4, 8, 2, 8]]",296
17,"[[0, 4, 0, 2], [0, 0, 0, 4], [0, 0, 0, 64], [4, 8, 2, 8]]",296,up,0,"[[4, 4, 2, 2], [0, 8, 0, 4], [0, 0, 0, 64], [0, 0, 4, 8]]",296
17,"[[4, 4, 2, 2], [0, 8, 0, 4], [0, 0, 0, 64], [0, 0, 4, 8]]",296,left,12,"[[8, 4, 0, 0], [8, 4, 0, 0], [64, 0, 4, 0], [4, 8, 0, 0]]",308
17,"[[8, 4, 0, 0], [8, 4, 0, 0], [64, 0, 4, 0], [4, 8, 0, 0]]",308,up,24,"[[16, 8, 4, 0], [64, 8, 0, 0], [4, 0, 0, 0], [0, 4, 0, 0]]",332
17,"[[16, 8, 4, 0], [64, 8, 0, 0], [4, 0, 0, 0], [0, 4, 0, 0]]",332,up,16,"[[16, 16, 4, 0], [64, 4, 0, 0], [4, 0, 0, 0], [0, 0, 0, 2]]",348
17,"[[16, 16, 4, 0], [64, 4, 0, 0], [4, 0, 0, 0], [0, 0, 0, 2]]",348,left,32,"[[32, 4, 0, 0], [64, 4, 0, 0], [4, 0, 0, 0], [2, 0, 4, 0]]",380
17,"[[32, 4, 0, 0], [64, 4, 0, 0], [4, 0, 0, 0], [2, 0, 4, 0]]",380,right,0,"[[4, 0, 32, 4], [0, 0, 64, 4], [0, 0, 0, 4], [0, 0, 2, 4]]",380
17,"[[4, 0, 32, 4], [0, 0, 64, 4], [0, 0, 0, 4], [0, 0, 2, 4]]",380,up,16,"[[4, 0, 32, 8], [0, 0, 64, 8], [0, 0, 2, 4], [0, 0, 0, 0]]",396
17,"[[4, 0, 32, 8], [0, 0, 64, 8], [0, 0, 2, 4], [0, 0, 0, 0]]",396,up,16,"[[4, 0, 32, 16], [0, 2, 64, 4], [0, 0, 2, 0], [0, 0, 0, 0]]",412
17,"[[4, 0, 32, 16], [0, 2, 64, 4], [0, 0, 2, 0], [0, 0, 0, 0]]",412,down,0,"[[0, 0, 0, 0], [2, 0, 32, 0], [0, 0, 64, 16], [4, 2, 2, 4]]",412
17,"[[0, 0, 0, 0], [2, 0, 32, 0], [0, 0, 64, 16], [4, 2, 2, 4]]",412,right,4,"[[0, 0, 0, 2], [0, 0, 2, 32], [0, 0, 64, 16], [0, 4, 4, 4]]",416
17,"[[0, 0, 0, 2], [0, 0, 2, 32], [0, 0, 64, 16], [0, 4, 4, 4]]",416,right,8,"[[0, 0, 0, 2], [0, 4, 2, 32], [0, 0, 64, 16], [0, 0, 4, 8]]",424
17,"[[0, 0, 0, 2], [0, 4, 2, 32], [0, 0, 64, 16], [0, 0, 4, 8]]",424,down,0,"[[0, 0, 0, 2], [0, 0, 2, 32], [2, 0, 64, 16], [0, 4, 4, 8]]",424
17,"[[0, 0, 0, 2], [0, 0, 2, 32], [2, 0, 64, 16], [0, 4, 4, 8]]",424,right,8,"[[4, 0, 0, 2], [0, 0, 2, 32], [0, 2, 64, 16], [0, 0, 8, 8]]",432
17,"[[4, 0, 0, 2], [0, 0, 2, 32], [0, 2, 64, 16], [0, 0, 8, 8]]",432,right,16,"[[0, 0, 4, 2], [0, 0, 2, 32], [2, 2, 64, 16], [0, 0, 0, 16]]",448
17,"[[0, 0, 4, 2], [0, 0, 2, 32], [2, 2, 64, 16], [0, 0, 0, 16]]",448,up,32,"[[2, 2, 4, 2], [0, 0, 2, 32], [0, 0, 64, 32], [0, 0, 0, 2]]",480
17,"[[2, 2, 4, 2], [0, 0, 2, 32], [0, 0, 64, 32], [0, 0, 0, 2]]",480,down,64,"[[0, 0, 0, 0], [0, 0, 4, 2], [0, 2, 2, 64], [2, 2, 64, 2]]",544
17,"[[0, 0, 0, 0], [0, 0, 4, 2], [0, 2, 2, 64], [2, 2, 64, 2]]",544,right,8,"[[0, 0, 0, 0], [0, 0, 4, 2], [2, 0, 4, 64], [0, 4, 64, 2]]",552
17,"[[0, 0, 0, 0], [0, 0, 4, 2], [2, 0, 4, 64], [0, 4, 64, 2]]",552,up,8,"[[2, 4, 8, 2], [0, 4, 64, 64], [0, 0, 0, 2], [0, 0, 0, 0]]",560
17,"[[2, 4, 8, 2], [0, 4, 64, 64], [0, 0, 0, 2], [0, 0, 0, 0]]",560,right,128,"[[2, 4, 8, 2], [0, 0, 4, 128], [2, 0, 0, 2], [0, 0, 0, 0]]",688
17,"[[2, 4, 8, 2], [0, 0, 4, 128], [2, 0, 0, 2], [0, 0, 0, 0]]",688,up,4,"[[4, 4, 8, 2], [0, 0, 4, 128], [0, 0, 0, 2], [4, 0, 0, 0]]",692
17,"[[4, 4, 8, 2], [0, 0, 4, 128], [0, 0, 0, 2], [4, 0, 0, 0]]",692,down,8,"[[0, 0, 0, 2], [0, 0, 0, 2], [0, 0, 8, 128], [8, 4, 4, 2]]",700
17,"[[0, 0, 0, 2], [0, 0, 0, 2], [0, 0, 8, 128], [8, 4, 4, 2]]",700,right,8,"[[0, 0, 2, 2], [0, 0, 0, 2], [0, 0, 8, 128], [0, 8, 8, 2]]",708
17,"[[0, 0, 2, 2], [0, 0, 0, 2], [0, 0, 8, 128], [0, 8, 8, 2]]",708,left,20,"[[4, 0, 0, 0], [2, 2, 0, 0], [8, 128, 0, 0], [16, 2, 0, 0]]",728
17,"[[4, 0, 0, 0], [2, 2, 0, 0], [8, 128, 0, 0], [16, 2, 0, 0]]",728,left,4,"[[4, 0, 0, 0], [4, 0, 0, 0], [8, 128, 0, 0], [16, 2, 4, 0]]",732
17,"[[4, 0, 0, 0], [4, 0, 0, 0], [8, 128, 0, 0], [16, 2, 4, 0]]",732,up,8,"[[8, 128, 4, 0], [8, 2, 0, 0], [16, 4, 0, 0], [0, 0, 0, 0]]",740
17,"[[8, 128, 4, 0], [8, 2, 0, 0], [16, 4, 0, 0], [0, 0, 0, 0]]",740,down,16,"[[0, 0, 0, 0], [0, 128, 4, 0], [16, 2, 0, 0], [16, 4, 4, 0]]",756
17,"[[0, 0, 0, 0], [0, 128, 4, 0], [16, 2, 0, 0], [16, 4, 4, 0]]",756,up,40,"[[32, 128, 8, 0], [0, 2, 0, 0], [0, 4, 2, 0], [0, 0, 0, 0]]",796
17,"[[32, 128, 8, 0], [0, 2, 0, 0], [0, 4, 2, 0], [0, 0, 0, 0]]",796,up,0,"[[32, 128, 8, 0], [0, 2, 2, 0], [0, 4, 0, 0], [0, 2, 0, 0]]",796
17,"[[32, 128, 8, 0], [0, 2, 2, 0], [0, 4, 0, 0], [0, 2, 0, 0]]",796,right,4,"[[0, 32, 128, 8], [0, 0, 2, 4], [0, 0, 0, 4], [0, 0, 0, 2]]",800
17,"[[0, 32, 128, 8], [0, 0, 2, 4], [0, 0, 0, 4], [0, 0, 0, 2]]",800,up,8,"[[0, 32, 128, 8], [0, 0, 2, 8], [4, 0, 0, 2], [0, 0, 0, 0]]",808
17,"[[0, 32, 128, 8], [0, 0, 2, 8], [4, 0, 0, 2], [0, 0, 0, 0]]",808,up,16,"[[4, 32, 128, 16], [4, 0, 2, 2], [0, 0, 0, 0], [0, 0, 0, 0]]",824
17,"[[4, 32, 128, 16], [4, 0, 2, 2], [0, 0, 0, 0], [0, 0, 0, 0]]",824,up,8,"[[8, 32, 128, 16], [0, 0, 2, 2], [2, 0, 0, 0], [0, 0, 0, 0]]",832
17,"[[8, 32, 128, 16], [0, 0, 2, 2], [2, 0, 0, 0], [0, 0, 0, 0]]",832,right,4,"[[8, 32, 128, 16], [0, 0, 0, 4], [0, 0, 0, 2], [0, 0, 2, 0]]",836
17,"[[8, 32, 128, 16], [0, 0, 0, 4], [0, 0, 0, 2], [0, 0, 2, 0]]",836,right,0,"[[8, 32, 128, 16], [0, 0, 0, 4], [0, 0, 4, 2], [0, 0, 0, 2]]",836
17,"[[8, 32, 128, 16], [0, 0, 0, 4], [0, 0, 4, 2], [0, 0, 0, 2]]",836,up,4,"[[8, 32, 128, 16], [0, 0, 4, 4], [0, 0, 0, 4], [0, 0, 4, 0]]",840
17,"[[8, 32, 128, 16], [0, 0, 4, 4], [0, 0, 0, 4], [0, 0, 4, 0]]",840,down,16,"[[0, 0, 0, 0], [0, 4, 0, 0], [0, 0, 128, 16], [8, 32, 8, 8]]",856
17,"[[0, 0, 0, 0], [0, 4, 0, 0], [0, 0, 128, 16], [8, 32, 8, 8]]",856,right,16,"[[0, 0, 0, 2], [0, 0, 0, 4], [0, 0, 128, 16], [0, 8, 32, 16]]",872
17,"[[0, 0, 0, 2], [0, 0, 0, 4], [0, 0, 128, 16], [0, 8, 32, 16]]",872,down,32,"[[0, 0, 0, 0], [0, 0, 2, 2], [0, 0, 128, 4], [0, 8, 32, 32]]",904
17,"[[0, 0, 0, 0], [0, 0, 2, 2], [0, 0, 128, 4], [0, 8, 32, 32]]",904,right,68,"[[0, 0, 0, 0], [0, 0, 4, 4], [0, 0, 128, 4], [0, 0, 8, 64]]",972
17,"[[0, 0, 0, 0], [0, 0, 4, 4], [0, 0, 128, 4], [0, 0, 8, 64]]",972,down,8,"[[0, 2, 0, 0], [0, 0, 4, 0], [0, 0, 128, 8], [0, 0, 8, 64]]",980
17,"[[0, 2, 0, 0], [0, 0, 4, 0], [0, 0, 128, 8], [0, 0, 8, 64]]",980,right,0,"[[4, 0, 0, 2], [0, 0, 0, 4], [0, 0, 128, 8], [0, 0, 8, 64]]",980
17,"[[4, 0, 0, 2], [0, 0, 0, 4], [0, 0, 128, 8], [0, 0, 8, 64]]",980,left,0,"[[4, 2, 0, 0], [4, 0, 0, 0], [128, 8, 0, 0], [8, 64, 2, 0]]",980
17,"[[4, 2, 0, 0], [4, 0, 0, 0], [128, 8, 0, 0], [8, 64, 2, 0]]",980,up,8,"[[8, 2, 2, 0], [128, 8, 0, 0], [8, 64, 0, 2], [0, 0, 0, 0]]",988
17,"[[8, 2, 2, 0], [128, 8, 0, 0], [8, 64, 0, 2], [0, 0, 0, 0]]",988,left,4,"[[8, 4, 0, 0], [128, 8, 0, 0], [8, 64, 2, 4], [0, 0, 0, 0]]",992
17,"[[8, 4, 0, 0], [128, 8, 0, 0], [8, 64, 2, 4], [0, 0, 0, 0]]",992,left,0,"[[8, 4, 0, 0], [128, 8, 0, 0], [8, 64, 2, 4], [0, 0, 0, 2]]",992
17,"[[8, 4, 0, 0], [128, 8, 0, 0], [8, 64, 2, 4], [0, 0, 0, 2]]",992,down,0,"[[0, 2, 0, 0], [8, 4, 0, 0], [128, 8, 0, 4], [8, 64, 2, 2]]",992
17,"[[0, 2, 0, 0], [8, 4, 0, 0], [128, 8, 0, 4], [8, 64, 2, 2]]",992,left,4,"[[2, 0, 0, 0], [8, 4, 0, 0], [128, 8, 4, 2], [8, 64, 4, 0]]",996
17,"[[2, 0, 0, 0], [8, 4, 0, 0], [128, 8, 4, 2], [8, 64, 4, 0]]",996,up,8,"[[2, 4, 8, 2], [8, 8, 0, 0], [128, 64, 0, 0], [8, 0, 0, 2]]",1004
17,"[[2, 4, 8, 2], [8, 8, 0, 0], [128, 64, 0, 0], [8, 0, 0, 2]]",1004,left,16,"[[2, 4, 8, 2], [16, 0, 0, 0], [128, 64, 0, 0], [8, 2, 0, 4]]",1020
17,"[[2, 4, 8, 2], [16, 0, 0, 0], [128, 64, 0, 0], [8, 2, 0, 4]]",1020,left,0,"[[2, 4, 8, 2], [16, 0, 0, 0], [128, 64, 0, 0], [8, 2, 4, 4]]",1020
17,"[[2, 4, 8, 2], [16, 0, 0, 0], [128, 64, 0, 0], [8, 2, 4, 4]]",1020,left,8,"[[2, 4, 8, 2], [16, 0, 4, 0], [128, 64, 0, 0], [8, 2, 8, 0]]",1028
17,"[[2, 4, 8, 2], [16, 0, 4, 0], [128, 64, 0, 0], [8, 2, 8, 0]]",1028,left,0,"[[2, 4, 8, 2], [16, 4, 4, 0], [128, 64, 0, 0], [8, 2, 8, 0]]",1028
17,"[[2, 4, 8, 2], [16, 4, 4, 0], [128, 64, 0, 0], [8, 2, 8, 0]]",1028,down,8,"[[2, 0, 4, 0], [16, 8, 8, 0], [128, 64, 4, 0], [8, 2, 8, 2]]",1036
17,"[[2, 0, 4, 0], [16, 8, 8, 0], [128, 64, 4, 0], [8, 2, 8, 2]]",1036,left,16,"[[2, 4, 0, 0], [16, 16, 0, 0], [128, 64, 4, 2], [8, 2, 8, 2]]",1052
17,"[[2, 4, 0, 0], [16, 16, 0, 0], [128, 64, 4, 2], [8, 2, 8, 2]]",1052,right,32,"[[0, 0, 2, 4], [0, 0, 4, 32], [128, 64, 4, 2], [8, 2, 8, 2]]",1084
17,"[[0, 0, 2, 4], [0, 0, 4, 32], [128, 64, 4, 2], [8, 2, 8, 2]]",1084,down,12,"[[0, 2, 0, 0], [0, 0, 2, 4], [128, 64, 8, 32], [8, 2, 8, 4]]",1096
17,"[[0, 2, 0, 0], [0, 0, 2, 4], [128, 64, 8, 32], [8, 2, 8, 4]]",1096,up,16,"[[128, 2, 2, 4], [8, 64, 16, 32], [0, 2, 0, 4], [0, 4, 0, 0]]",1112
17,"[[128, 2, 2, 4], [8, 64, 16, 32], [0, 2, 0, 4], [0, 4, 0, 0]]",1112,left,4,"[[128, 4, 4, 4], [8, 64, 16, 32], [2, 4, 0, 0], [4, 0, 0, 0]]",1116
17,"[[128, 4, 4, 4], [8, 64, 16, 32], [2, 4, 0, 0], [4, 0, 0, 0]]",1116,right,8,"[[0, 128, 4, 8], [8, 64, 16, 32], [0, 0, 2, 4], [2, 0, 0, 4]]",1124
17,"[[0, 128, 4, 8], [8, 64, 16, 32], [0, 0, 2, 4], [2, 0, 0, 4]]",1124,down,8,"[[0, 0, 0, 0], [0, 2, 4, 8], [8, 128, 16, 32], [2, 64, 2, 8]]",1132
17,"[[0, 0, 0, 0], [0, 2, 4, 8], [8, 128, 16, 32], [2, 64, 2, 8]]",1132,left,0,"[[0, 2, 0, 0], [2, 4, 8, 0], [8, 128, 16, 32], [2, 64, 2, 8]]",1132
17,"[[0, 2, 0, 0], [2, 4, 8, 0], [8, 128, 16, 32], [2, 64, 2, 8]]",1132,left,0,"[[2, 0, 0, 0], [2, 4, 8, 4], [8, 128, 16, 32], [2, 64, 2, 8]]",1132
17,"[[2, 0, 0, 0], [2, 4, 8, 4], [8, 128, 16, 32], [2, 64, 2, 8]]",1132,down,4,"[[0, 0, 4, 0], [4, 4, 8, 4], [8, 128, 16, 32], [2, 64, 2, 8]]",1136
17,"[[0, 0, 4, 0], [4, 4, 8, 4], [8, 128, 16, 32], [2, 64, 2, 8]]",1136,right,8,"[[0, 2, 0, 4], [0, 8, 8, 4], [8, 128, 16, 32], [2, 64, 2, 8]]",1144
17,"[[0, 2, 0, 4], [0, 8, 8, 4], [8, 128, 16, 32], [2, 64, 2, 8]]",1144,right,16,"[[0, 4, 2, 4], [0, 0, 16, 4], [8, 128, 16, 32], [2, 64, 2, 8]]",1160
17,"[[0, 4, 2, 4], [0, 0, 16, 4], [8, 128, 16, 32], [2, 64, 2, 8]]",1160,down,40,"[[2, 0, 0, 0], [0, 4, 2, 8], [8, 128, 32, 32], [2, 64, 2, 8]]",1200
17,"[[2, 0, 0, 0], [0, 4, 2, 8], [8, 128, 32, 32], [2, 64, 2, 8]]",1200,left,64,"[[2, 0, 0, 0], [4, 2, 8, 4], [8, 128, 64, 0], [2, 64, 2, 8]]",1264
17,"[[2, 0, 0, 0], [4, 2, 8, 4], [8, 128, 64, 0], [2, 64, 2, 8]]",1264,up,0,"[[2, 2, 8, 4], [4, 128, 64, 8], [8, 64, 2, 0], [2, 0, 2, 0]]",1264
17,"[[2, 2, 8, 4], [4, 128, 64, 8], [8, 64, 2, 0], [2, 0, 2, 0]]",1264,right,8,"[[0, 4, 8, 4], [4, 128, 64, 8], [0, 8, 64, 2], [0, 2, 0, 4]]",1272
17,"[[0, 4, 8, 4], [4, 128, 64, 8], [0, 8, 64, 2], [0, 2, 0, 4]]",1272,up,128,"[[4, 4, 8, 4], [0, 128, 128, 8], [4, 8, 0, 2], [0, 2, 0, 4]]",1400
17,"[[4, 4, 8, 4], [0, 128, 128, 8], [4, 8, 0, 2], [0, 2, 0, 4]]",1400,left,264,"[[8, 8, 4, 0], [256, 8, 0, 0], [4, 8, 2, 2], [2, 4, 0, 0]]",1664
17,"[[8, 8, 4, 0], [256, 8, 0, 0], [4, 8, 2, 2], [2, 4, 0, 0]]",1664,left,20,"[[16, 4, 0, 0], [256, 8, 0, 0], [4, 8, 4, 4], [2, 4, 0, 0]]",1684
17,"[[16, 4, 0, 0], [256, 8, 0, 0], [4, 8, 4, 4], [2, 4, 0, 0]]",1684,up,16,"[[16, 4, 4, 4], [256, 16, 4, 0], [4, 4, 0, 0], [2, 0, 0, 0]]",1700
17,"[[16, 4, 4, 4], [256, 16, 4, 0], [4, 4, 0, 0], [2, 0, 0, 0]]",1700,left,16,"[[16, 8, 4, 0], [256, 16, 4, 0], [8, 2, 0, 0], [2, 0, 0, 0]]",1716
17,"[[16, 8, 4, 0], [256, 16, 4, 0], [8, 2, 0, 0], [2, 0, 0, 0]]",1716,up,8,"[[16, 8, 8, 0], [256, 16, 0, 0], [8, 2, 0, 4], [2, 0, 0, 0]]",1724
17,"[[16, 8, 8, 0], [256, 16, 0, 0], [8, 2, 0, 4], [2, 0, 0, 0]]",1724,right,16,"[[0, 0, 16, 16], [0, 4, 256, 16], [0, 8, 2, 4], [0, 0, 0, 2]]",1740
17,"[[0, 0, 16, 16], [0, 4, 256, 16], [0, 8, 2, 4], [0, 0, 0, 2]]",1740,down,32,"[[0, 4, 0, 0], [0, 0, 16, 32], [0, 4, 256, 4], [0, 8, 2, 2]]",1772
17,"[[0, 4, 0, 0], [0, 0, 16, 32], [0, 4, 256, 4], [0, 8, 2, 2]]",1772,up,8,"[[0, 8, 16, 32], [0, 8, 256, 4], [0, 4, 2, 2], [0, 0, 0, 0]]",1780
17,"[[0, 8, 16, 32], [0, 8, 256, 4], [0, 4, 2, 2], [0, 0, 0, 0]]",1780,up,16,"[[0, 16, 16, 32], [0, 4, 256, 4], [0, 0, 2, 2], [0, 0, 4, 0]]",1796
17,"[[0, 16, 16, 32], [0, 4, 256, 4], [0, 0, 2, 2], [0, 0, 4, 0]]",1796,left,36,"[[32, 32, 0, 0], [4, 256, 4, 0], [4, 0, 0, 0], [4, 4, 0, 0]]",1832
17,"[[32, 32, 0, 0], [4, 256, 4, 0], [4, 0, 0, 0], [4, 4, 0, 0]]",1832,left,72,"[[64, 0, 0, 0], [4, 256, 4, 0], [4, 4, 0, 0], [8, 0, 0, 0]]",1904
17,"[[64, 0, 0, 0], [4, 256, 4, 0], [4, 4, 0, 0], [8, 0, 0, 0]]",1904,down,8,"[[0, 0, 0, 4], [64, 0, 0, 0], [8, 256, 0, 0], [8, 4, 4, 0]]",1912
17,"[[0, 0, 0, 4], [64, 0, 0, 0], [8, 256, 0, 0], [8, 4, 4, 0]]",1912,up,16,"[[64, 256, 4, 4], [16, 4, 0, 0], [0, 0, 2, 0], [0, 0, 0, 0]]",1928
17,"[[64, 256, 4, 4], [16, 4, 0, 0], [0, 0, 2, 0], [0, 0, 0, 0]]",1928,left,8,"[[64, 256, 8, 0], [16, 4, 0, 0], [2, 0, 0, 0], [0, 4, 0, 0]]",1936
17,"[[64, 256, 8, 0], [16, 4, 0, 0], [2, 0, 0, 0], [0, 4, 0, 0]]",1936,down,8,"[[0, 4, 0, 0], [64, 0, 0, 0], [16, 256, 0, 0], [2, 8, 8, 0]]",1944
17,"[[0, 4, 0, 0], [64, 0, 0, 0], [16, 256, 0, 0], [2, 8, 8, 0]]",1944,right,16,"[[0, 0, 0, 4], [0, 0, 4, 64], [0, 0, 16, 256], [0, 0, 2, 16]]",1960
17,"[[0, 0, 0, 4], [0, 0, 4, 64], [0, 0, 16, 256], [0, 0, 2, 16]]",1960,left,0,"[[4, 2, 0, 0], [4, 64, 0, 0], [16, 256, 0, 0], [2, 16, 0, 0]]",1960
17,"[[4, 2, 0, 0], [4, 64, 0, 0], [16, 256, 0, 0], [2, 16, 0, 0]]",1960,right,0,"[[0, 0, 4, 2], [0, 0, 4, 64], [0, 2, 16, 256], [0, 0, 2, 16]]",1960
17,"[[0, 0, 4, 2], [0, 0, 4, 64], [0, 2, 16, 256], [0, 0, 2, 16]]",1960,left,0,"[[4, 2, 0, 0], [4, 64, 0, 2], [2, 16, 256, 0], [2, 16, 0, 0]]",1960
17,"[[4, 2, 0, 0], [4, 64, 0, 2], [2, 16, 256, 0], [2, 16, 0, 0]]",1960,down,44,"[[4, 0, 0, 0], [0, 2, 0, 0], [8, 64, 0, 0], [4, 32, 256, 2]]",2004
17,"[[4, 0, 0, 0], [0, 2, 0, 0], [8, 64, 0, 0], [4, 32, 256, 2]]",2004,down,0,"[[0, 0, 0, 0], [4, 2, 0, 0], [8, 64, 0, 4], [4, 32, 256, 2]]",2004
17,"[[0, 0, 0, 0], [4, 2, 0, 0], [8, 64, 0, 4], [4, 32, 256, 2]]",2004,down,0,"[[0, 0, 0, 0], [4, 2, 0, 4], [8, 64, 0, 4], [4, 32, 256, 2]]",2004
17,"[[0, 0, 0, 0], [4, 2, 0, 4], [8, 64, 0, 4], [4, 32, 256, 2]]",2004,right,0,"[[0, 0, 0, 0], [0, 4, 2, 4], [2, 8, 64, 4], [4, 32, 256, 2]]",2004
17,"[[0, 0, 0, 0], [0, 4, 2, 4], [2, 8, 64, 4], [4, 32, 256, 2]]",2004,down,8,"[[0, 0, 0, 0], [2, 4, 2, 0], [2, 8, 64, 8], [4, 32, 256, 2]]",2012
17,"[[0, 0, 0, 0], [2, 4, 2, 0], [2, 8, 64, 8], [4, 32, 256, 2]]",2012,down,4,"[[0, 0, 0, 2], [0, 4, 2, 0], [4, 8, 64, 8], [4, 32, 256, 2]]",2016
17,"[[0, 0, 0, 2], [0, 4, 2, 0], [4, 8, 64, 8], [4, 32, 256, 2]]",2016,up,8,"[[8, 4, 2, 2], [0, 8, 64, 8], [0, 32, 256, 2], [0, 0, 0, 2]]",2024
17,"[[8, 4, 2, 2], [0, 8, 64, 8], [0, 32, 256, 2], [0, 0, 0, 2]]",2024,right,4,"[[0, 8, 4, 4], [0, 8, 64, 8], [2, 32, 256, 2], [0, 0, 0, 2]]",2028
17,"[[0, 8, 4, 4], [0, 8, 64, 8], [2, 32, 256, 2], [0, 0, 0, 2]]",2028,up,20,"[[2, 16, 4, 4], [0, 32, 64, 8], [0, 0, 256, 4], [0, 0, 0, 2]]",2048
17,"[[2, 16, 4, 4], [0, 32, 64, 8], [0, 0, 256, 4], [0, 0, 0, 2]]",2048,left,8,"[[2, 16, 8, 0], [32, 64, 8, 0], [256, 4, 0, 0], [2, 0, 0, 4]]",2056
17,"[[2, 16, 8, 0], [32, 64, 8, 0], [256, 4, 0, 0], [2, 0, 0, 4]]",2056,up,16,"[[2, 16, 16, 4], [32, 64, 0, 2], [256, 4, 0, 0], [2, 0, 0, 0]]",2072
17,"[[2, 16, 16, 4], [32, 64, 0, 2], [256, 4, 0, 0], [2, 0, 0, 0]]",2072,left,32,"[[2, 32, 4, 0], [32, 64, 2, 0], [256, 4, 0, 0], [2, 0, 0, 4]]",2104
17,"[[2, 32, 4, 0], [32, 64, 2, 0], [256, 4, 0, 0], [2, 0, 0, 4]]",2104,down,0,"[[2, 0, 0, 2], [32, 32, 0, 0], [256, 64, 4, 0], [2, 4, 2, 4]]",2104
17,"[[2, 0, 0, 2], [32, 32, 0, 0], [256, 64, 4, 0], [2, 4, 2, 4]]",2104,left,68,"[[4, 0, 0, 4], [64, 0, 0, 0], [256, 64, 4, 0], [2, 4, 2, 4]]",2172
17,"[[4, 0, 0, 4], [64, 0, 0, 0], [256, 64, 4, 0], [2, 4, 2, 4]]",2172,right,8,"[[0, 4, 0, 8], [0, 0, 0, 64], [0, 256, 64, 4], [2, 4, 2, 4]]",2180
17,"[[0, 4, 0, 8], [0, 0, 0, 64], [0, 256, 64, 4], [2, 4, 2, 4]]",2180,down,8,"[[0, 4, 0, 0], [0, 4, 0, 8], [0, 256, 64, 64], [2, 4, 2, 8]]",2188
17,"[[0, 4, 0, 0], [0, 4, 0, 8], [0, 256, 64, 64], [2, 4, 2, 8]]",2188,left,128,"[[4, 0, 0, 4], [4, 8, 0, 0], [256, 128, 0, 0], [2, 4, 2, 8]]",2316
17,"[[4, 0, 0, 4], [4, 8, 0, 0], [256, 128, 0, 0], [2, 4, 2, 8]]",2316,up,8,"[[8, 8, 2, 4], [256, 128, 0, 8], [2, 4, 0, 0], [2, 0, 0, 0]]",2324
17,"[[8, 8, 2, 4], [256, 128, 0, 8], [2, 4, 0, 0], [2, 0, 0, 0]]",2324,up,4,"[[8, 8, 2, 4], [256, 128, 0, 8], [4, 4, 4, 0], [0, 0, 0, 0]]",2328
17,"[[8, 8, 2, 4], [256, 128, 0, 8], [4, 4, 4, 0], [0, 0, 0, 0]]",2328,right,24,"[[0, 16, 2, 4], [0, 256, 128, 8], [4, 0, 4, 8], [0, 0, 0, 0]]",2352
17,"[[0, 16, 2, 4], [0, 256, 128, 8], [4, 0, 4, 8], [0, 0, 0, 0]]",2352,left,8,"[[16, 2, 4, 0], [256, 128, 8, 0], [8, 8, 4, 0], [0, 0, 0, 0]]",2360
17,"[[16, 2, 4, 0], [256, 128, 8, 0], [8, 8, 4, 0], [0, 0, 0, 0]]",2360,left,16,"[[16, 2, 4, 0], [256, 128, 8, 2], [16, 4, 0, 0], [0, 0, 0, 0]]",2376
17,"[[16, 2, 4, 0], [256, 128, 8, 2], [16, 4, 0, 0], [0, 0, 0, 0]]",2376,left,0,"[[16, 2, 4, 4], [256, 128, 8, 2], [16, 4, 0, 0], [0, 0, 0, 0]]",2376
17,"[[16, 2, 4, 4], [256, 128, 8, 2], [16, 4, 0, 0], [0, 0, 0, 0]]",2376,left,8,"[[16, 2, 8, 0], [256, 128, 8, 2], [16, 4, 4, 0], [0, 0, 0, 0]]",2384
17,"[[16, 2, 8, 0], [256, 128, 8, 2], [16, 4, 4, 0], [0, 0, 0, 0]]",2384,up,16,"[[16, 2, 16, 2], [256, 128, 4, 0], [16, 4, 0, 0], [0, 2, 0, 0]]",2400
17,"[[16, 2, 16, 2], [256, 128, 4, 0], [16, 4, 0, 0], [0, 2, 0, 0]]",2400,up,0,"[[16, 2, 16, 2], [256, 128, 4, 0], [16, 4, 0, 0], [0, 2, 4, 0]]",2400
17,"[[16, 2, 16, 2], [256, 128, 4, 0], [16, 4, 0, 0], [0, 2, 4, 0]]",2400,left,0,"[[16, 2, 16, 2], [256, 128, 4, 0], [16, 4, 0, 4], [2, 4, 0, 0]]",2400
17,"[[16, 2, 16, 2], [256, 128, 4, 0], [16, 4, 0, 4], [2, 4, 0, 0]]",2400,up,8,"[[16, 2, 16, 2], [256, 128, 4, 4], [16, 8, 0, 0], [2, 2, 0, 0]]",2408
17,"[[16, 2, 16, 2], [256, 128, 4, 4], [16, 8, 0, 0], [2, 2, 0, 0]]",2408,right,12,"[[16, 2, 16, 2], [0, 256, 128, 8], [0, 0, 16, 8], [0, 0, 2, 4]]",2420
17,"[[16, 2, 16, 2], [0, 256, 128, 8], [0, 0, 16, 8], [0, 0, 2, 4]]",2420,down,16,"[[0, 0, 16, 0], [0, 2, 128, 2], [0, 2, 16, 16], [16, 256, 2, 4]]",2436
17,"[[0, 0, 16, 0], [0, 2, 128, 2], [0, 2, 16, 16], [16, 256, 2, 4]]",2436,left,32,"[[16, 4, 0, 0], [2, 128, 2, 0], [2, 32, 0, 0], [16, 256, 2, 4]]",2468
17,"[[16, 4, 0, 0], [2, 128, 2, 0], [2, 32, 0, 0], [16, 256, 2, 4]]",2468,up,8,"[[16, 4, 4, 4], [4, 128, 0, 0], [16, 32, 0, 0], [0, 256, 0, 4]]",2476
17,"[[16, 4, 4, 4], [4, 128, 0, 0], [16, 32, 0, 0], [0, 256, 0, 4]]",2476,right,8,"[[0, 16, 4, 8], [0, 0, 4, 128], [0, 4, 16, 32], [0, 0, 256, 4]]",2484
17,"[[0, 16, 4, 8], [0, 0, 4, 128], [0, 4, 16, 32], [0, 0, 256, 4]]",2484,up,8,"[[0, 16, 8, 8], [0, 4, 16, 128], [4, 0, 256, 32], [0, 0, 0, 4]]",2492
17,"[[0, 16, 8, 8], [0, 4, 16, 128], [4, 0, 256, 32], [0, 0, 0, 4]]",2492,right,16,"[[0, 0, 16, 16], [0, 4, 16, 128], [0, 4, 256, 32], [0, 0, 2, 4]]",2508
17,"[[0, 0, 16, 16], [0, 4, 16, 128], [0, 4, 256, 32], [0, 0, 2, 4]]",2508,down,40,"[[0, 0, 0, 16], [0, 2, 32, 128], [0, 0, 256, 32], [0, 8, 2, 4]]",2548
17,"[[0, 0, 0, 16], [0, 2, 32, 128], [0, 0, 256, 32], [0, 8, 2, 4]]",2548,left,0,"[[16, 0, 0, 4], [2, 32, 128, 0], [256, 32, 0, 0], [8, 2, 4, 0]]",2548
17,"[[16, 0, 0, 4], [2, 32, 128, 0], [256, 32, 0, 0], [8, 2, 4, 0]]",2548,up,64,"[[16, 64, 128, 4], [2, 2, 4, 0], [256, 0, 0, 0], [8, 0, 2, 0]]",2612
17,"[[16, 64, 128, 4], [2, 2, 4, 0], [256, 0, 0, 0], [8, 0, 2, 0]]",2612,right,4,"[[16, 64, 128, 4], [4, 0, 4, 4], [0, 0, 0, 256], [0, 0, 8, 2]]",2616
17,"[[16, 64, 128, 4], [4, 0, 4, 4], [0, 0, 0, 256], [0, 0, 8, 2]]",2616,right,8,"[[16, 64, 128, 4], [0, 2, 4, 8], [0, 0, 0, 256], [0, 0, 8, 2]]",2624
17,"[[16, 64, 128, 4], [0, 2, 4, 8], [0, 0, 0, 256], [0, 0, 8, 2]]",2624,up,0,"[[16, 64, 128, 4], [0, 2, 4, 8], [0, 0, 8, 256], [2, 0, 0, 2]]",2624
17,"[[16, 64, 128, 4], [0, 2, 4, 8], [0, 0, 8, 256], [2, 0, 0, 2]]",2624,up,0,"[[16, 64, 128, 4], [2, 2, 4, 8], [0, 4, 8, 256], [0, 0, 0, 2]]",2624
17,"[[16, 64, 128, 4], [2, 2, 4, 8], [0, 4, 8, 256], [0, 0, 0, 2]]",2624,left,4,"[[16, 64, 128, 4], [4, 4, 8, 0], [4, 8, 256, 0], [2, 2, 0, 0]]",2628
17,"[[16, 64, 128, 4], [4, 4, 8, 0], [4, 8, 256, 0], [2, 2, 0, 0]]",2628,left,12,"[[16, 64, 128, 4], [8, 8, 0, 0], [4, 8, 256, 4], [4, 0, 0, 0]]",2640
17,"[[16, 64, 128, 4], [8, 8, 0, 0], [4, 8, 256, 4], [4, 0, 0, 0]]",2640,up,32,"[[16, 64, 128, 8], [8, 16, 256, 0], [8, 0, 0, 0], [0, 2, 0, 0]]",2672
17,"[[16, 64, 128, 8], [8, 16, 256, 0], [8, 0, 0, 0], [0, 2, 0, 0]]",2672,up,16,"[[16, 64, 128, 8], [16, 16, 256, 0], [0, 2, 0, 0], [0, 0, 2, 0]]",2688
17,"[[16, 64, 128, 8], [16, 16, 256, 0], [0, 2, 0, 0], [0, 0, 2, 0]]",2688,left,32,"[[16, 64, 128, 8], [32, 256, 0, 0], [2, 0, 2, 0], [2, 0, 0, 0]]",2720
17,"[[16, 64, 128, 8], [32, 256, 0, 0], [2, 0, 2, 0], [2, 0, 0, 0]]",2720,up,4,"[[16, 64, 128, 8], [32, 256, 2, 0], [4, 4, 0, 0], [0, 0, 0, 0]]",2724
17,"[[16, 64, 128, 8], [32, 256, 2, 0], [4, 4, 0, 0], [0, 0, 0, 0]]",2724,left,8,"[[16, 64, 128, 8], [32, 256, 2, 0], [8, 0, 0, 0], [0, 0, 2, 0]]",2732
17,"[[16, 64, 128, 8], [32, 256, 2, 0], [8, 0, 0, 0], [0, 0, 2, 0]]",2732,up,4,"[[16, 64, 128, 8], [32, 256, 4, 0], [8, 0, 0, 0], [0, 4, 0, 0]]",2736
17,"[[16, 64, 128, 8], [32, 256, 4, 0], [8, 0, 0, 0], [0, 4, 0, 0]]",2736,down,0,"[[4, 0, 0, 0], [16, 64, 0, 0], [32, 256, 128, 0], [8, 4, 4, 8]]",2736
17,"[[4, 0, 0, 0], [16, 64, 0, 0], [32, 256, 128, 0], [8, 4, 4, 8]]",2736,left,8,"[[4, 0, 0, 0], [16, 64, 0, 0], [32, 256, 128, 2], [8, 8, 8, 0]]",2744
17,"[[4, 0, 0, 0], [16, 64, 0, 0], [32, 256, 128, 2], [8, 8, 8, 0]]",2744,left,16,"[[4, 0, 4, 0], [16, 64, 0, 0], [32, 256, 128, 2], [16, 8, 0, 0]]",2760
17,"[[4, 0, 4, 0], [16, 64, 0, 0], [32, 256, 128, 2], [16, 8, 0, 0]]",2760,left,8,"[[8, 0, 4, 0], [16, 64, 0, 0], [32, 256, 128, 2], [16, 8, 0, 0]]",2768
17,"[[8, 0, 4, 0], [16, 64, 0, 0], [32, 256, 128, 2], [16, 8, 0, 0]]",2768,up,0,"[[8, 64, 4, 2], [16, 256, 128, 2], [32, 8, 0, 0], [16, 0, 0, 0]]",2768
17,"[[8, 64, 4, 2], [16, 256, 128, 2], [32, 8, 0, 0], [16, 0, 0, 0]]",2768,up,4,"[[8, 64, 4, 4], [16, 256, 128, 4], [32, 8, 0, 0], [16, 0, 0, 0]]",2772
17,"[[8, 64, 4, 4], [16, 256, 128, 4], [32, 8, 0, 0], [16, 0, 0, 0]]",2772,left,8,"[[8, 64, 8, 0], [16, 256, 128, 4], [32, 8, 0, 0], [16, 4, 0, 0]]",2780
17,"[[8, 64, 8, 0], [16, 256, 128, 4], [32, 8, 0, 0], [16, 4, 0, 0]]",2780,down,0,"[[8, 64, 0, 2], [16, 256, 0, 0], [32, 8, 8, 0], [16, 4, 128, 4]]",2780
17,"[[8, 64, 0, 2], [16, 256, 0, 0], [32, 8, 8, 0], [16, 4, 128, 4]]",2780,right,16,"[[0, 8, 64, 2], [0, 0, 16, 256], [2, 0, 32, 16], [16, 4, 128, 4]]",2796
17,"[[0, 8, 64, 2], [0, 0, 16, 256], [2, 0, 32, 16], [16, 4, 128, 4]]",2796,up,0,"[[2, 8, 64, 2], [16, 4, 16, 256], [0, 2, 32, 16], [0, 0, 128, 4]]",2796
17,"[[2, 8, 64, 2], [16, 4, 16, 256], [0, 2, 32, 16], [0, 0, 128, 4]]",2796,left,0,"[[2, 8, 64, 2], [16, 4, 16, 256], [2, 32, 16, 0], [128, 4, 2, 0]]",2796
17,"[[2, 8, 64, 2], [16, 4, 16, 256], [2, 32, 16, 0], [128, 4, 2, 0]]",2796,down,32,"[[2, 8, 0, 2], [16, 4, 64, 0], [2, 32, 32, 2], [128, 4, 2, 256]]",2828
17,"[[2, 8, 0, 2], [16, 4, 64, 0], [2, 32, 32, 2], [128, 4, 2, 256]]",2828,left,64,"[[2, 8, 2, 2], [16, 4, 64, 0], [2, 64, 2, 0], [128, 4, 2, 256]]",2892
17,"[[2, 8, 2, 2], [16, 4, 64, 0], [2, 64, 2, 0], [128, 4, 2, 256]]",2892,down,4,"[[2, 8, 0, 0], [16, 4, 2, 4], [2, 64, 64, 2], [128, 4, 4, 256]]",2896
17,"[[2, 8, 0, 0], [16, 4, 2, 4], [2, 64, 64, 2], [128, 4, 4, 256]]",2896,right,136,"[[0, 4, 2, 8], [16, 4, 2, 4], [0, 2, 128, 2], [0, 128, 8, 256]]",3032
17,"[[0, 4, 2, 8], [16, 4, 2, 4], [0, 2, 128, 2], [0, 128, 8, 256]]",3032,down,12,"[[0, 0, 0, 8], [0, 8, 4, 4], [2, 2, 128, 2], [16, 128, 8, 256]]",3044
17,"[[0, 0, 0, 8], [0, 8, 4, 4], [2, 2, 128, 2], [16, 128, 8, 256]]",3044,left,12,"[[8, 0, 0, 0], [8, 8, 0, 2], [4, 128, 2, 0], [16, 128, 8, 256]]",3056
17,"[[8, 0, 0, 0], [8, 8, 0, 2], [4, 128, 2, 0], [16, 128, 8, 256]]",3056,down,272,"[[0, 0, 0, 0], [16, 4, 0, 0], [4, 8, 2, 2], [16, 256, 8, 256]]",3328
17,"[[0, 0, 0, 0], [16, 4, 0, 0], [4, 8, 2, 2], [16, 256, 8, 256]]",3328,right,4,"[[0, 0, 0, 0], [0, 4, 16, 4], [0, 4, 8, 4], [16, 256, 8, 256]]",3332
17,"[[0, 0, 0, 0], [0, 4, 16, 4], [0, 4, 8, 4], [16, 256, 8, 256]]",3332,down,32,"[[0, 0, 0, 4], [0, 0, 0, 0], [0, 8, 16, 8], [16, 256, 16, 256]]",3364
17,"[[0, 0, 0, 4], [0, 0, 0, 0], [0, 8, 16, 8], [16, 256, 16, 256]]",3364,down,32,"[[0, 2, 0, 0], [0, 0, 0, 4], [0, 8, 0, 8], [16, 256, 32, 256]]",3396
17,"[[0, 2, 0, 0], [0, 0, 0, 4], [0, 8, 0, 8], [16, 256, 32, 256]]",3396,up,0,"[[16, 2, 32, 4], [0, 8, 0, 8], [0, 256, 0, 256], [4, 0, 0, 0]]",3396
17,"[[16, 2, 32, 4], [0, 8, 0, 8], [0, 256, 0, 256], [4, 0, 0, 0]]",3396,left,528,"[[16, 2, 32, 4], [16, 0, 0, 0], [512, 0, 0, 0], [4, 0, 0, 2]]",3924
17,"[[16, 2, 32, 4], [16, 0, 0, 0], [512, 0, 0, 0], [4, 0, 0, 2]]",3924,up,32,"[[32, 2, 32, 4], [512, 0, 0, 2], [4, 0, 2, 0], [0, 0, 0, 0]]",3956
17,"[[32, 2, 32, 4], [512, 0, 0, 2], [4, 0, 2, 0], [0, 0, 0, 0]]",3956,up,0,"[[32, 2, 32, 4], [512, 0, 2, 2], [4, 0, 0, 0], [4, 0, 0, 0]]",3956
17,"[[32, 2, 32, 4], [512, 0, 2, 2], [4, 0, 0, 0], [4, 0, 0, 0]]",3956,down,8,"[[0, 0, 0, 0], [32, 0, 4, 0], [512, 0, 32, 4], [8, 2, 2, 2]]",3964
17,"[[0, 0, 0, 0], [32, 0, 4, 0], [512, 0, 32, 4], [8, 2, 2, 2]]",3964,right,4,"[[0, 0, 0, 0], [0, 0, 32, 4], [2, 512, 32, 4], [0, 8, 2, 4]]",3968
17,"[[0, 0, 0, 0], [0, 0, 32, 4], [2, 512, 32, 4], [0, 8, 2, 4]]",3968,up,72,"[[2, 512, 64, 8], [0, 8, 2, 4], [0, 0, 0, 0], [0, 0, 4, 0]]",4040
17,"[[2, 512, 64, 8], [0, 8, 2, 4], [0, 0, 0, 0], [0, 0, 4, 0]]",4040,right,0,"[[2, 512, 64, 8], [0, 8, 2, 4], [0, 0, 0, 0], [2, 0, 0, 4]]",4040
17,"[[2, 512, 64, 8], [0, 8, 2, 4], [0, 0, 0, 0], [2, 0, 0, 4]]",4040,down,12,"[[0, 0, 4, 0], [0, 0, 0, 0], [0, 512, 64, 8], [4, 8, 2, 8]]",4052
17,"[[0, 0, 4, 0], [0, 0, 0, 0], [0, 512, 64, 8], [4, 8, 2, 8]]",4052,down,16,"[[0, 0, 0, 0], [0, 2, 4, 0], [0, 512, 64, 0], [4, 8, 2, 16]]",4068
17,"[[0, 0, 0, 0], [0, 2, 4, 0], [0, 512, 64, 0], [4, 8, 2, 16]]",4068,right,0,"[[0, 0, 0, 2], [0, 0, 2, 4], [0, 0, 512, 64], [4, 8, 2, 16]]",4068
17,"[[0, 0, 0, 2], [0, 0, 2, 4], [0, 0, 512, 64], [4, 8, 2, 16]]",4068,up,0,"[[4, 8, 2, 2], [0, 0, 512, 4], [0, 4, 2, 64], [0, 0, 0, 16]]",4068
17,"[[4, 8, 2, 2], [0, 0, 512, 4], [0, 4, 2, 64], [0, 0, 0, 16]]",4068,right,4,"[[0, 4, 8, 4], [0, 2, 512, 4], [0, 4, 2, 64], [0, 0, 0, 16]]",4072
17,"[[0, 4, 8, 4], [0, 2, 512, 4], [0, 4, 2, 64], [0, 0, 0, 16]]",4072,up,8,"[[0, 4, 8, 8], [2, 2, 512, 64], [0, 4, 2, 16], [0, 0, 0, 0]]",4080
17,"[[0, 4, 8, 8], [2, 2, 512, 64], [0, 4, 2, 16], [0, 0, 0, 0]]",4080,left,20,"[[4, 16, 0, 4], [4, 512, 64, 0], [4, 2, 16, 0], [0, 0, 0, 0]]",4100
17,"[[4, 16, 0, 4], [4, 512, 64, 0], [4, 2, 16, 0], [0, 0, 0, 0]]",4100,down,8,"[[0, 0, 0, 0], [4, 16, 0, 0], [4, 512, 64, 0], [8, 2, 16, 4]]",4108
17,"[[0, 0, 0, 0], [4, 16, 0, 0], [4, 512, 64, 0], [8, 2, 16, 4]]",4108,down,8,"[[0, 0, 0, 2], [0, 16, 0, 0], [8, 512, 64, 0], [8, 2, 16, 4]]",4116
17,"[[0, 0, 0, 2], [0, 16, 0, 0], [8, 512, 64, 0], [8, 2, 16, 4]]",4116,up,16,"[[16, 16, 64, 2], [0, 512, 16, 4], [0, 2, 0, 0], [4, 0, 0, 0]]",4132
17,"[[16, 16, 64, 2], [0, 512, 16, 4], [0, 2, 0, 0], [4, 0, 0, 0]]",4132,left,32,"[[32, 64, 2, 0], [512, 16, 4, 0], [2, 0, 0, 0], [4, 0, 0, 2]]",4164
17,"[[32, 64, 2, 0], [512, 16, 4, 0], [2, 0, 0, 0], [4, 0, 0, 2]]",4164,up,0,"[[32, 64, 2, 2], [512, 16, 4, 0], [2, 0, 0, 0], [4, 0, 0, 2]]",4164
17,"[[32, 64, 2, 2], [512, 16, 4, 0], [2, 0, 0, 0], [4, 0, 0, 2]]",4164,right,4,"[[0, 32, 64, 4], [0, 512, 16, 4], [4, 0, 0, 2], [0, 0, 4, 2]]",4168
17,"[[0, 32, 64, 4], [0, 512, 16, 4], [4, 0, 0, 2], [0, 0, 4, 2]]",4168,down,12,"[[0, 0, 0, 0], [0, 0, 64, 4], [0, 32, 16, 8], [4, 512, 4, 4]]",4180
17,"[[0, 0, 0, 0], [0, 0, 64, 4], [0, 32, 16, 8], [4, 512, 4, 4]]",4180,right,8,"[[0, 0, 2, 0], [0, 0, 64, 4], [0, 32, 16, 8], [0, 4, 512, 8]]",4188
17,"[[0, 0, 2, 0], [0, 0, 64, 4], [0, 32, 16, 8], [0, 4, 512, 8]]",4188,up,16,"[[0, 32, 2, 4], [0, 4, 64, 16], [0, 0, 16, 0], [4, 0, 512, 0]]",4204
17,"[[0, 32, 2, 4], [0, 4, 64, 16], [0, 0, 16, 0], [4, 0, 512, 0]]",4204,right,0,"[[0, 32, 2, 4], [0, 4, 64, 16], [0, 0, 0, 16], [2, 0, 4, 512]]",4204
17,"[[0, 32, 2, 4], [0, 4, 64, 16], [0, 0, 0, 16], [2, 0, 4, 512]]",4204,down,32,"[[0, 0, 4, 0], [0, 0, 2, 4], [0, 32, 64, 32], [2, 4, 4, 512]]",4236
17,"[[0, 0, 4, 0], [0, 0, 2, 4], [0, 32, 64, 32], [2, 4, 4, 512]]",4236,right,8,"[[0, 0, 0, 4], [0, 2, 2, 4], [0, 32, 64, 32], [0, 2, 8, 512]]",4244
17,"[[0, 0, 0, 4], [0, 2, 2, 4], [0, 32, 64, 32], [0, 2, 8, 512]]",4244,left,4,"[[4, 0, 0, 0], [4, 4, 0, 2], [32, 64, 32, 0], [2, 8, 512, 0]]",4248
17,"[[4, 0, 0, 0], [4, 4, 0, 2], [32, 64, 32, 0], [2, 8, 512, 0]]",4248,up,8,"[[8, 4, 32, 2], [32, 64, 512, 0], [2, 8, 0, 0], [0, 2, 0, 0]]",4256
17,"[[8, 4, 32, 2], [32, 64, 512, 0], [2, 8, 0, 0], [0, 2, 0, 0]]",4256,down,0,"[[0, 4, 0, 0], [8, 64, 0, 2], [32, 8, 32, 0], [2, 2, 512, 2]]",4256
17,"[[0, 4, 0, 0], [8, 64, 0, 2], [32, 8, 32, 0], [2, 2, 512, 2]]",4256,down,4,"[[0, 4, 4, 0], [8, 64, 0, 0], [32, 8, 32, 0], [2, 2, 512, 4]]",4260
17,"[[0, 4, 4, 0], [8, 64, 0, 0], [32, 8, 32, 0], [2, 2, 512, 4]]",4260,left,12,"[[8, 0, 0, 0], [8, 64, 4, 0], [32, 8, 32, 0], [4, 512, 4, 0]]",4272
17,"[[8, 0, 0, 0], [8, 64, 4, 0], [32, 8, 32, 0], [4, 512, 4, 0]]",4272,up,16,"[[16, 64, 4, 0], [32, 8, 32, 0], [4, 512, 4, 0], [0, 4, 0, 0]]",4288
17,"[[16, 64, 4, 0], [32, 8, 32, 0], [4, 512, 4, 0], [0, 4, 0, 0]]",4288,left,0,"[[16, 64, 4, 0], [32, 8, 32, 0], [4, 512, 4, 0], [4, 0, 4, 0]]",4288
17,"[[16, 64, 4, 0], [32, 8, 32, 0], [4, 512, 4, 0], [4, 0, 4, 0]]",4288,up,16,"[[16, 64, 4, 0], [32, 8, 32, 0], [8, 512, 8, 0], [4, 0, 0, 0]]",4304
17,"[[16, 64, 4, 0], [32, 8, 32, 0], [8, 512, 8, 0], [4, 0, 0, 0]]",4304,down,0,"[[16, 0, 0, 2], [32, 64, 4, 0], [8, 8, 32, 0], [4, 512, 8, 0]]",4304
17,"[[16, 0, 0, 2], [32, 64, 4, 0], [8, 8, 32, 0], [4, 512, 8, 0]]",4304,left,16,"[[16, 2, 2, 0], [32, 64, 4, 0], [16, 32, 0, 0], [4, 512, 8, 0]]",4320
17,"[[16, 2, 2, 0], [32, 64, 4, 0], [16, 32, 0, 0], [4, 512, 8, 0]]",4320,up,0,"[[16, 2, 2, 0], [32, 64, 4, 2], [16, 32, 8, 0], [4, 512, 0, 0]]",4320
17,"[[16, 2, 2, 0], [32, 64, 4, 2], [16, 32, 8, 0], [4, 512, 0, 0]]",4320,down,0,"[[16, 2, 0, 0], [32, 64, 2, 2], [16, 32, 4, 0], [4, 512, 8, 2]]",4320
17,"[[16, 2, 0, 0], [32, 64, 2, 2], [16, 32, 4, 0], [4, 512, 8, 2]]",4320,up,4,"[[16, 2, 2, 4], [32, 64, 4, 0], [16, 32, 8, 0], [4, 512, 4, 0]]",4324
17,"[[16, 2, 2, 4], [32, 64, 4, 0], [16, 32, 8, 0], [4, 512, 4, 0]]",4324,left,4,"[[16, 4, 4, 0], [32, 64, 4, 0], [16, 32, 8, 4], [4, 512, 4, 0]]",4328
17,"[[16, 4, 4, 0], [32, 64, 4, 0], [16, 32, 8, 4], [4, 512, 4, 0]]",4328,right,8,"[[4, 0, 16, 8], [0, 32, 64, 4], [16, 32, 8, 4], [0, 4, 512, 4]]",4336
17,"[[4, 0, 16, 8], [0, 32, 64, 4], [16, 32, 8, 4], [0, 4, 512, 4]]",4336,up,72,"[[4, 64, 16, 8], [16, 4, 64, 8], [0, 0, 8, 4], [0, 2, 512, 0]]",4408
17,"[[4, 64, 16, 8], [16, 4, 64, 8], [0, 0, 8, 4], [0, 2, 512, 0]]",4408,down,16,"[[2, 0, 16, 0], [0, 64, 64, 0], [4, 4, 8, 16], [16, 2, 512, 4]]",4424
17,"[[2, 0, 16, 0], [0, 64, 64, 0], [4, 4, 8, 16], [16, 2, 512, 4]]",4424,left,136,"[[2, 16, 0, 0], [128, 0, 0, 0], [8, 8, 16, 2], [16, 2, 512, 4]]",4560
17,"[[2, 16, 0, 0], [128, 0, 0, 0], [8, 8, 16, 2], [16, 2, 512, 4]]",4560,left,16,"[[2, 16, 0, 0], [128, 0, 4, 0], [16, 16, 2, 0], [16, 2, 512, 4]]",4576
17,"[[2, 16, 0, 0], [128, 0, 4, 0], [16, 16, 2, 0], [16, 2, 512, 4]]",4576,up,64,"[[2, 32, 4, 4], [128, 2, 2, 0], [32, 0, 512, 0], [0, 0, 0, 2]]",4640
17,"[[2, 32, 4, 4], [128, 2, 2, 0], [32, 0, 512, 0], [0, 0, 0, 2]]",4640,left,12,"[[2, 32, 8, 0], [128, 4, 4, 0], [32, 512, 0, 0], [2, 0, 0, 0]]",4652
17,"[[2, 32, 8, 0], [128, 4, 4, 0], [32, 512, 0, 0], [2, 0, 0, 0]]",4652,right,8,"[[0, 2, 32, 8], [0, 0, 128, 8], [0, 0, 32, 512], [0, 0, 4, 2]]",4660
17,"[[0, 2, 32, 8], [0, 0, 128, 8], [0, 0, 32, 512], [0, 0, 4, 2]]",4660,up,16,"[[0, 2, 32, 16], [0, 0, 128, 512], [0, 0, 32, 2], [2, 0, 4, 0]]",4676
17,"[[0, 2, 32, 16], [0, 0, 128, 512], [0, 0, 32, 2], [2, 0, 4, 0]]",4676,down,0,"[[0, 0, 32, 2], [0, 0, 128, 16], [0, 0, 32, 512], [2, 2, 4, 2]]",4676
17,"[[0, 0, 32, 2], [0, 0, 128, 16], [0, 0, 32, 512], [2, 2, 4, 2]]",4676,left,4,"[[32, 2, 0, 4], [128, 16, 0, 0], [32, 512, 0, 0], [4, 4, 2, 0]]",4680
17,"[[32, 2, 0, 4], [128, 16, 0, 0], [32, 512, 0, 0], [4, 4, 2, 0]]",4680,right,8,"[[4, 32, 2, 4], [0, 0, 128, 16], [0, 0, 32, 512], [0, 0, 8, 2]]",4688
17,"[[4, 32, 2, 4], [0, 0, 128, 16], [0, 0, 32, 512], [0, 0, 8, 2]]",4688,down,0,"[[0, 2, 2, 4], [0, 0, 128, 16], [0, 0, 32, 512], [4, 32, 8, 2]]",4688
17,"[[0, 2, 2, 4], [0, 0, 128, 16], [0, 0, 32, 512], [4, 32, 8, 2]]",4688,down,0,"[[0, 0, 2, 4], [0, 2, 128, 16], [0, 2, 32, 512], [4, 32, 8, 2]]",4688
17,"[[0, 0, 2, 4], [0, 2, 128, 16], [0, 2, 32, 512], [4, 32, 8, 2]]",4688,left,0,"[[2, 4, 4, 0], [2, 128, 16, 0], [2, 32, 512, 0], [4, 32, 8, 2]]",4688
17,"[[2, 4, 4, 0], [2, 128, 16, 0], [2, 32, 512, 0], [4, 32, 8, 2]]",4688,down,68,"[[0, 0, 4, 0], [2, 4, 16, 0], [4, 128, 512, 4], [4, 64, 8, 2]]",4756
17,"[[0, 0, 4, 0], [2, 4, 16, 0], [4, 128, 512, 4], [4, 64, 8, 2]]",4756,up,8,"[[2, 4, 4, 4], [8, 128, 16, 2], [0, 64, 512, 0], [0, 0, 8, 4]]",4764
17,"[[2, 4, 4, 4], [8, 128, 16, 2], [0, 64, 512, 0], [0, 0, 8, 4]]",4764,left,8,"[[2, 8, 4, 0], [8, 128, 16, 2], [64, 512, 0, 0], [8, 4, 2, 0]]",4772
17,"[[2, 8, 4, 0], [8, 128, 16, 2], [64, 512, 0, 0], [8, 4, 2, 0]]",4772,down,0,"[[2, 8, 2, 0], [8, 128, 4, 0], [64, 512, 16, 0], [8, 4, 2, 2]]",4772
17,"[[2, 8, 2, 0], [8, 128, 4, 0], [64, 512, 16, 0], [8, 4, 2, 2]]",4772,right,4,"[[4, 2, 8, 2], [0, 8, 128, 4], [0, 64, 512, 16], [0, 8, 4, 4]]",4776
17,"[[4, 2, 8, 2], [0, 8, 128, 4], [0, 64, 512, 16], [0, 8, 4, 4]]",4776,right,8,"[[4, 2, 8, 2], [0, 8, 128, 4], [2, 64, 512, 16], [0, 0, 8, 8]]",4784
17,"[[4, 2, 8, 2], [0, 8, 128, 4], [2, 64, 512, 16], [0, 0, 8, 8]]",4784,right,16,"[[4, 2, 8, 2], [0, 8, 128, 4], [2, 64, 512, 16], [0, 4, 0, 16]]",4800
17,"[[4, 2, 8, 2], [0, 8, 128, 4], [2, 64, 512, 16], [0, 4, 0, 16]]",4800,down,32,"[[0, 2, 4, 0], [0, 8, 8, 2], [4, 64, 128, 4], [2, 4, 512, 32]]",4832
17,"[[0, 2, 4, 0], [0, 8, 8, 2], [4, 64, 128, 4], [2, 4, 512, 32]]",4832,right,16,"[[0, 0, 2, 4], [4, 0, 16, 2], [4, 64, 128, 4], [2, 4, 512, 32]]",4848
17,"[[0, 0, 2, 4], [4, 0, 16, 2], [4, 64, 128, 4], [2, 4, 512, 32]]",4848,up,8,"[[8, 64, 2, 4], [2, 4, 16, 2], [0, 0, 128, 4], [0, 4, 512, 32]]",4856
17,"[[8, 64, 2, 4], [2, 4, 16, 2], [0, 0, 128, 4], [0, 4, 512, 32]]",4856,down,8,"[[0, 0, 2, 4], [2, 0, 16, 2], [8, 64, 128, 4], [2, 8, 512, 32]]",4864
17,"[[0, 0, 2, 4], [2, 0, 16, 2], [8, 64, 128, 4], [2, 8, 512, 32]]",4864,up,0,"[[2, 64, 2, 4], [8, 8, 16, 2], [2, 0, 128, 4], [0, 2, 512, 32]]",4864
17,"[[2, 64, 2, 4], [8, 8, 16, 2], [2, 0, 128, 4], [0, 2, 512, 32]]",4864,left,16,"[[2, 64, 2, 4], [16, 16, 2, 0], [2, 128, 4, 0], [2, 512, 32, 2]]",4880
17,"[[2, 64, 2, 4], [16, 16, 2, 0], [2, 128, 4, 0], [2, 512, 32, 2]]",4880,up,8,"[[2, 64, 4, 4], [16, 16, 4, 2], [4, 128, 32, 0], [0, 512, 2, 0]]",4888
17,"[[2, 64, 4, 4], [16, 16, 4, 2], [4, 128, 32, 0], [0, 512, 2, 0]]",4888,up,8,"[[2, 64, 8, 4], [16, 16, 32, 2], [4, 128, 2, 0], [0, 512, 0, 4]]",4896
17,"[[2, 64, 8, 4], [16, 16, 32, 2], [4, 128, 2, 0], [0, 512, 0, 4]]",4896,left,32,"[[2, 64, 8, 4], [32, 32, 2, 0], [4, 128, 2, 0], [512, 4, 4, 0]]",4928
17,"[[2, 64, 8, 4], [32, 32, 2, 0], [4, 128, 2, 0], [512, 4, 4, 0]]",4928,left,72,"[[2, 64, 8, 4], [64, 2, 0, 0], [4, 128, 2, 0], [512, 8, 4, 0]]",5000
17,"[[2, 64, 8, 4], [64, 2, 0, 0], [4, 128, 2, 0], [512, 8, 4, 0]]",5000,right,0,"[[2, 64, 8, 4], [0, 0, 64, 2], [4, 4, 128, 2], [0, 512, 8, 4]]",5000
17,"[[2, 64, 8, 4], [0, 0, 64, 2], [4, 4, 128, 2], [0, 512, 8, 4]]",5000,down,4,"[[0, 2, 8, 0], [0, 64, 64, 4], [2, 4, 128, 4], [4, 512, 8, 4]]",5004
17,"[[0, 2, 8, 0], [0, 64, 64, 4], [2, 4, 128, 4], [4, 512, 8, 4]]",5004,right,128,"[[0, 2, 2, 8], [0, 0, 128, 4], [2, 4, 128, 4], [4, 512, 8, 4]]",5132
17,"[[0, 2, 2, 8], [0, 0, 128, 4], [2, 4, 128, 4], [4, 512, 8, 4]]",5132,up,264,"[[2, 2, 2, 8], [4, 4, 256, 8], [0, 512, 8, 4], [4, 0, 0, 0]]",5396
17,"[[2, 2, 2, 8], [4, 4, 256, 8], [0, 512, 8, 4], [4, 0, 0, 0]]",5396,right,12,"[[0, 2, 4, 8], [0, 8, 256, 8], [0, 512, 8, 4], [4, 0, 0, 4]]",5408
17,"[[0, 2, 4, 8], [0, 8, 256, 8], [0, 512, 8, 4], [4, 0, 0, 4]]",5408,down,24,"[[0, 0, 0, 0], [4, 2, 4, 0], [0, 8, 256, 16], [4, 512, 8, 8]]",5432
17,"[[0, 0, 0, 0], [4, 2, 4, 0], [0, 8, 256, 16], [4, 512, 8, 8]]",5432,right,16,"[[0, 0, 0, 2], [0, 4, 2, 4], [0, 8, 256, 16], [0, 4, 512, 16]]",5448
17,"[[0, 0, 0, 2], [0, 4, 2, 4], [0, 8, 256, 16], [0, 4, 512, 16]]",5448,down,32,"[[2, 0, 0, 0], [0, 4, 2, 2], [0, 8, 256, 4], [0, 4, 512, 32]]",5480
17,"[[2, 0, 0, 0], [0, 4, 2, 2], [0, 8, 256, 4], [0, 4, 512, 32]]",5480,right,4,"[[0, 0, 0, 2], [0, 0, 4, 4], [0, 8, 256, 4], [2, 4, 512, 32]]",5484
17,"[[0, 0, 0, 2], [0, 0, 4, 4], [0, 8, 256, 4], [2, 4, 512, 32]]",5484,left,8,"[[2, 0, 0, 4], [8, 0, 0, 0], [8, 256, 4, 0], [2, 4, 512, 32]]",5492
17,"[[2, 0, 0, 4], [8, 0, 0, 0], [8, 256, 4, 0], [2, 4, 512, 32]]",5492,up,16,"[[2, 256, 4, 4], [16, 4, 512, 32], [2, 4, 0, 0], [0, 0, 0, 0]]",5508
17,"[[2, 256, 4, 4], [16, 4, 512, 32], [2, 4, 0, 0], [0, 0, 0, 0]]",5508,down,8,"[[0, 0, 2, 0], [2, 0, 0, 0], [16, 256, 4, 4], [2, 8, 512, 32]]",5516
17,"[[0, 0, 2, 0], [2, 0, 0, 0], [16, 256, 4, 4], [2, 8, 512, 32]]",5516,right,8,"[[0, 0, 0, 2], [0, 2, 0, 2], [0, 16, 256, 8], [2, 8, 512, 32]]",5524
17,"[[0, 0, 0, 2], [0, 2, 0, 2], [0, 16, 256, 8], [2, 8, 512, 32]]",5524,right,4,"[[4, 0, 0, 2], [0, 0, 0, 4], [0, 16, 256, 8], [2, 8, 512, 32]]",5528
17,"[[4, 0, 0, 2], [0, 0, 0, 4], [0, 16, 256, 8], [2, 8, 512, 32]]",5528,left,0,"[[4, 2, 0, 2], [4, 0, 0, 0], [16, 256, 8, 0], [2, 8, 512, 32]]",5528
17,"[[4, 2, 0, 2], [4, 0, 0, 0], [16, 256, 8, 0], [2, 8, 512, 32]]",5528,left,4,"[[4, 4, 0, 0], [4, 0, 0, 2], [16, 256, 8, 0], [2, 8, 512, 32]]",5532
17,"[[4, 4, 0, 0], [4, 0, 0, 2], [16, 256, 8, 0], [2, 8, 512, 32]]",5532,down,8,"[[0, 2, 0, 0], [8, 4, 0, 0], [16, 256, 8, 2], [2, 8, 512, 32]]",5540
17,"[[0, 2, 0, 0], [8, 4, 0, 0], [16, 256, 8, 2], [2, 8, 512, 32]]",5540,right,0,"[[0, 0, 0, 2], [4, 0, 8, 4], [16, 256, 8, 2], [2, 8, 512, 32]]",5540
17,"[[0, 0, 0, 2], [4, 0, 8, 4], [16, 256, 8, 2], [2, 8, 512, 32]]",5540,down,16,"[[0, 0, 0, 2], [4, 0, 2, 4], [16, 256, 16, 2], [2, 8, 512, 32]]",5556
17,"[[0, 0, 0, 2], [4, 0, 2, 4], [16, 256, 16, 2], [2, 8, 512, 32]]",5556,down,0,"[[4, 0, 0, 2], [4, 0, 2, 4], [16, 256, 16, 2], [2, 8, 512, 32]]",5556
17,"[[4, 0, 0, 2], [4, 0, 2, 4], [16, 256, 16, 2], [2, 8, 512, 32]]",5556,up,8,"[[8, 256, 2, 2], [16, 8, 16, 4], [2, 0, 512, 2], [2, 0, 0, 32]]",5564
17,"[[8, 256, 2, 2], [16, 8, 16, 4], [2, 0, 512, 2], [2, 0, 0, 32]]",5564,right,4,"[[0, 8, 256, 4], [16, 8, 16, 4], [2, 2, 512, 2], [0, 0, 2, 32]]",5568
17,"[[0, 8, 256, 4], [16, 8, 16, 4], [2, 2, 512, 2], [0, 0, 2, 32]]",5568,up,24,"[[16, 16, 256, 8], [2, 2, 16, 2], [0, 0, 512, 32], [0, 0, 2, 2]]",5592
17,"[[16, 16, 256, 8], [2, 2, 16, 2], [0, 0, 512, 32], [0, 0, 2, 2]]",5592,left,40,"[[32, 256, 8, 0], [4, 16, 2, 0], [512, 32, 2, 0], [4, 0, 0, 0]]",5632
17,"[[32, 256, 8, 0], [4, 16, 2, 0], [512, 32, 2, 0], [4, 0, 0, 0]]",5632,up,4,"[[32, 256, 8, 0], [4, 16, 4, 0], [512, 32, 0, 0], [4, 0, 2, 0]]",5636
17,"[[32, 256, 8, 0], [4, 16, 4, 0], [512, 32, 0, 0], [4, 0, 2, 0]]",5636,down,0,"[[32, 4, 0, 0], [4, 256, 8, 0], [512, 16, 4, 0], [4, 32, 2, 0]]",5636
17,"[[32, 4, 0, 0], [4, 256, 8, 0], [512, 16, 4, 0], [4, 32, 2, 0]]",5636,down,0,"[[32, 4, 0, 0], [4, 256, 8, 4], [512, 16, 4, 0], [4, 32, 2, 0]]",5636
17,"[[32, 4, 0, 0], [4, 256, 8, 4], [512, 16, 4, 0], [4, 32, 2, 0]]",5636,right,0,"[[0, 0, 32, 4], [4, 256, 8, 4], [0, 512, 16, 4], [4, 4, 32, 2]]",5636
17,"[[0, 0, 32, 4], [4, 256, 8, 4], [0, 512, 16, 4], [4, 4, 32, 2]]",5636,up,16,"[[8, 256, 32, 8], [0, 512, 8, 4], [0, 4, 16, 2], [0, 2, 32, 0]]",5652
17,"[[8, 256, 32, 8], [0, 512, 8, 4], [0, 4, 16, 2], [0, 2, 32, 0]]",5652,down,0,"[[0, 256, 32, 0], [0, 512, 8, 8], [4, 4, 16, 4], [8, 2, 32, 2]]",5652
17,"[[0, 256, 32, 0], [0, 512, 8, 8], [4, 4, 16, 4], [8, 2, 32, 2]]",5652,left,24,"[[256, 32, 0, 0], [512, 16, 2, 0], [8, 16, 4, 0], [8, 2, 32, 2]]",5676
17,"[[256, 32, 0, 0], [512, 16, 2, 0], [8, 16, 4, 0], [8, 2, 32, 2]]",5676,up,48,"[[256, 32, 2, 2], [512, 32, 4, 4], [16, 2, 32, 0], [0, 0, 0, 0]]",5724
17,"[[256, 32, 2, 2], [512, 32, 4, 4], [16, 2, 32, 0], [0, 0, 0, 0]]",5724,up,64,"[[256, 64, 2, 2], [512, 2, 4, 4], [16, 4, 32, 0], [0, 0, 0, 0]]",5788
17,"[[256, 64, 2, 2], [512, 2, 4, 4], [16, 4, 32, 0], [0, 0, 0, 0]]",5788,left,12,"[[256, 64, 4, 0], [512, 2, 8, 0], [16, 4, 32, 0], [0, 0, 4, 0]]",5800
17,"[[256, 64, 4, 0], [512, 2, 8, 0], [16, 4, 32, 0], [0, 0, 4, 0]]",5800,up,0,"[[256, 64, 4, 0], [512, 2, 8, 4], [16, 4, 32, 0], [0, 0, 4, 0]]",5800
17,"[[256, 64, 4, 0], [512, 2, 8, 4], [16, 4, 32, 0], [0, 0, 4, 0]]",5800,right,0,"[[0, 256, 64, 4], [512, 2, 8, 4], [2, 16, 4, 32], [0, 0, 0, 4]]",5800
17,"[[0, 256, 64, 4], [512, 2, 8, 4], [2, 16, 4, 32], [0, 0, 0, 4]]",5800,down,8,"[[0, 0, 0, 0], [4, 256, 64, 8], [512, 2, 8, 32], [2, 16, 4, 4]]",5808
17,"[[0, 0, 0, 0], [4, 256, 64, 8], [512, 2, 8, 32], [2, 16, 4, 4]]",5808,left,8,"[[0, 0, 4, 0], [4, 256, 64, 8], [512, 2, 8, 32], [2, 16, 8, 0]]",5816
17,"[[0, 0, 4, 0], [4, 256, 64, 8], [512, 2, 8, 32], [2, 16, 8, 0]]",5816,down,16,"[[0, 0, 2, 0], [4, 256, 4, 0], [512, 2, 64, 8], [2, 16, 16, 32]]",5832
17,"[[0, 0, 2, 0], [4, 256, 4, 0], [512, 2, 64, 8], [2, 16, 16, 32]]",5832,left,32,"[[2, 0, 0, 2], [4, 256, 4, 0], [512, 2, 64, 8], [2, 32, 32, 0]]",5864
17,"[[2, 0, 0, 2], [4, 256, 4, 0], [512, 2, 64, 8], [2, 32, 32, 0]]",5864,right,68,"[[0, 4, 0, 4], [0, 4, 256, 4], [512, 2, 64, 8], [0, 0, 2, 64]]",5932
17,"[[0, 4, 0, 4], [0, 4, 256, 4], [512, 2, 64, 8], [0, 0, 2, 64]]",5932,up,16,"[[512, 8, 256, 8], [4, 2, 64, 8], [0, 0, 2, 64], [0, 0, 0, 0]]",5948
17,"[[512, 8, 256, 8], [4, 2, 64, 8], [0, 0, 2, 64], [0, 0, 0, 0]]",5948,up,16,"[[512, 8, 256, 16], [4, 2, 64, 64], [2, 0, 2, 0], [0, 0, 0, 0]]",5964
17,"[[512, 8, 256, 16], [4, 2, 64, 64], [2, 0, 2, 0], [0, 0, 0, 0]]",5964,left,132,"[[512, 8, 256, 16], [4, 2, 128, 0], [4, 0, 2, 0], [0, 0, 0, 0]]",6096
17,"[[512, 8, 256, 16], [4, 2, 128, 0], [4, 0, 2, 0], [0, 0, 0, 0]]",6096,up,8,"[[512, 8, 256, 16], [8, 2, 128, 0], [0, 4, 2, 0], [0, 0, 0, 0]]",6104
17,"[[512, 8, 256, 16], [8, 2, 128, 0], [0, 4, 2, 0], [0, 0, 0, 0]]",6104,right,0,"[[512, 8, 256, 16], [0, 8, 2, 128], [0, 4, 4, 2], [0, 0, 0, 0]]",6104
17,"[[512, 8, 256, 16], [0, 8, 2, 128], [0, 4, 4, 2], [0, 0, 0, 0]]",6104,left,8,"[[512, 8, 256, 16], [8, 2, 128, 0], [8, 2, 0, 0], [0, 0, 2, 0]]",6112
17,"[[512, 8, 256, 16], [8, 2, 128, 0], [8, 2, 0, 0], [0, 0, 2, 0]]",6112,up,20,"[[512, 8, 256, 16], [16, 4, 128, 0], [0, 0, 2, 0], [0, 4, 0, 0]]",6132
17,"[[512, 8, 256, 16], [16, 4, 128, 0], [0, 0, 2, 0], [0, 4, 0, 0]]",6132,up,8,"[[512, 8, 256, 16], [16, 8, 128, 2], [0, 0, 2, 0], [0, 0, 0, 0]]",6140
17,"[[512, 8, 256, 16], [16, 8, 128, 2], [0, 0, 2, 0], [0, 0, 0, 0]]",6140,down,16,"[[0, 0, 0, 0], [2, 0, 256, 0], [512, 0, 128, 16], [16, 16, 2, 2]]",6156
17,"[[0, 0, 0, 0], [2, 0, 256, 0], [512, 0, 128, 16], [16, 16, 2, 2]]",6156,right,36,"[[4, 0, 0, 0], [0, 0, 2, 256], [0, 512, 128, 16], [0, 0, 32, 4]]",6192
17,"[[4, 0, 0, 0], [0, 0, 2, 256], [0, 512, 128, 16], [0, 0, 32, 4]]",6192,up,0,"[[4, 512, 2, 256], [0, 0, 128, 16], [0, 0, 32, 4], [4, 0, 0, 0]]",6192
17,"[[4, 512, 2, 256], [0, 0, 128, 16], [0, 0, 32, 4], [4, 0, 0, 0]]",6192,down,8,"[[0, 0, 0, 0], [0, 0, 2, 256], [0, 2, 128, 16], [8, 512, 32, 4]]",6200
17,"[[0, 0, 0, 0], [0, 0, 2, 256], [0, 2, 128, 16], [8, 512, 32, 4]]",6200,right,0,"[[0, 0, 0, 4], [0, 0, 2, 256], [0, 2, 128, 16], [8, 512, 32, 4]]",6200
17,"[[0, 0, 0, 4], [0, 0, 2, 256], [0, 2, 128, 16], [8, 512, 32, 4]]",6200,up,0,"[[8, 2, 2, 4], [0, 512, 128, 256], [0, 0, 32, 16], [2, 0, 0, 4]]",6200
17,"[[8, 2, 2, 4], [0, 512, 128, 256], [0, 0, 32, 16], [2, 0, 0, 4]]",6200,left,4,"[[8, 4, 4, 0], [512, 128, 256, 0], [32, 16, 0, 2], [2, 4, 0, 0]]",6204
17,"[[8, 4, 4, 0], [512, 128, 256, 0], [32, 16, 0, 2], [2, 4, 0, 0]]",6204,left,8,"[[8, 8, 0, 0], [512, 128, 256, 0], [32, 16, 2, 4], [2, 4, 0, 0]]",6212
17,"[[8, 8, 0, 0], [512, 128, 256, 0], [32, 16, 2, 4], [2, 4, 0, 0]]",6212,right,16,"[[0, 0, 0, 16], [0, 512, 128, 256], [32, 16, 2, 4], [4, 0, 2, 4]]",6228
17,"[[0, 0, 0, 16], [0, 512, 128, 256], [32, 16, 2, 4], [4, 0, 2, 4]]",6228,up,12,"[[32, 512, 128, 16], [4, 16, 4, 256], [0, 0, 0, 8], [0, 0, 4, 0]]",6240
17,"[[32, 512, 128, 16], [4, 16, 4, 256], [0, 0, 0, 8], [0, 0, 4, 0]]",6240,down,8,"[[0, 0, 0, 2], [0, 0, 0, 16], [32, 512, 128, 256], [4, 16, 8, 8]]",6248
17,"[[0, 0, 0, 2], [0, 0, 0, 16], [32, 512, 128, 256], [4, 16, 8, 8]]",6248,left,16,"[[2, 0, 0, 0], [16, 0, 4, 0], [32, 512, 128, 256], [4, 16, 16, 0]]",6264
17,"[[2, 0, 0, 0], [16, 0, 4, 0], [32, 512, 128, 256], [4, 16, 16, 0]]",6264,left,32,"[[2, 0, 0, 0], [16, 4, 2, 0], [32, 512, 128, 256], [4, 32, 0, 0]]",6296
17,"[[2, 0, 0, 0], [16, 4, 2, 0], [32, 512, 128, 256], [4, 32, 0, 0]]",6296,up,0,"[[2, 4, 2, 256], [16, 512, 128, 0], [32, 32, 2, 0], [4, 0, 0, 0]]",6296
17,"[[2, 4, 2, 256], [16, 512, 128, 0], [32, 32, 2, 0], [4, 0, 0, 0]]",6296,right,64,"[[2, 4, 2, 256], [0, 16, 512, 128], [4, 0, 64, 2], [0, 0, 0, 4]]",6360
17,"[[2, 4, 2, 256], [0, 16, 512, 128], [4, 0, 64, 2], [0, 0, 0, 4]]",6360,left,0,"[[2, 4, 2, 256], [16, 512, 128, 4], [4, 64, 2, 0], [4, 0, 0, 0]]",6360
17,"[[2, 4, 2, 256], [16, 512, 128, 4], [4, 64, 2, 0], [4, 0, 0, 0]]",6360,up,8,"[[2, 4, 2, 256], [16, 512, 128, 4], [8, 64, 2, 4], [0, 0, 0, 0]]",6368
17,"[[2, 4, 2, 256], [16, 512, 128, 4], [8, 64, 2, 4], [0, 0, 0, 0]]",6368,down,8,"[[0, 0, 0, 0], [2, 4, 2, 2], [16, 512, 128, 256], [8, 64, 2, 8]]",6376
17,"[[0, 0, 0, 0], [2, 4, 2, 2], [16, 512, 128, 256], [8, 64, 2, 8]]",6376,right,4,"[[0, 0, 0, 0], [2, 2, 4, 4], [16, 512, 128, 256], [8, 64, 2, 8]]",6380
17,"[[0, 0, 0, 0], [2, 2, 4, 4], [16, 512, 128, 256], [8, 64, 2, 8]]",6380,right,12,"[[4, 0, 0, 0], [0, 0, 4, 8], [16, 512, 128, 256], [8, 64, 2, 8]]",6392
17,"[[4, 0, 0, 0], [0, 0, 4, 8], [16, 512, 128, 256], [8, 64, 2, 8]]",6392,left,0,"[[4, 4, 0, 0], [4, 8, 0, 0], [16, 512, 128, 256], [8, 64, 2, 8]]",6392
17,"[[4, 4, 0, 0], [4, 8, 0, 0], [16, 512, 128, 256], [8, 64, 2, 8]]",6392,down,8,"[[0, 4, 0, 0], [8, 8, 2, 0], [16, 512, 128, 256], [8, 64, 2, 8]]",6400
17,"[[0, 4, 0, 0], [8, 8, 2, 0], [16, 512, 128, 256], [8, 64, 2, 8]]",6400,left,16,"[[4, 0, 4, 0], [16, 2, 0, 0], [16, 512, 128, 256], [8, 64, 2, 8]]",6416
17,"[[4, 0, 4, 0], [16, 2, 0, 0], [16, 512, 128, 256], [8, 64, 2, 8]]",6416,down,32,"[[2, 0, 0, 0], [4, 2, 4, 0], [32, 512, 128, 256], [8, 64, 2, 8]]",6448
17,"[[2, 0, 0, 0], [4, 2, 4, 0], [32, 512, 128, 256], [8, 64, 2, 8]]",6448,up,0,"[[2, 2, 4, 256], [4, 512, 128, 8], [32, 64, 2, 0], [8, 0, 0, 4]]",6448
17,"[[2, 2, 4, 256], [4, 512, 128, 8], [32, 64, 2, 0], [8, 0, 0, 4]]",6448,left,4,"[[4, 4, 256, 0], [4, 512, 128, 8], [32, 64, 2, 0], [8, 4, 4, 0]]",6452
17,"[[4, 4, 256, 0], [4, 512, 128, 8], [32, 64, 2, 0], [8, 4, 4, 0]]",6452,right,16,"[[2, 0, 8, 256], [4, 512, 128, 8], [0, 32, 64, 2], [0, 0, 8, 8]]",6468
17,"[[2, 0, 8, 256], [4, 512, 128, 8], [0, 32, 64, 2], [0, 0, 8, 8]]",6468,right,16,"[[0, 2, 8, 256], [4, 512, 128, 8], [0, 32, 64, 2], [2, 0, 0, 16]]",6484
17,"[[0, 2, 8, 256], [4, 512, 128, 8], [0, 32, 64, 2], [2, 0, 0, 16]]",6484,down,0,"[[2, 0, 0, 256], [0, 2, 8, 8], [4, 512, 128, 2], [2, 32, 64, 16]]",6484
17,"[[2, 0, 0, 256], [0, 2, 8, 8], [4, 512, 128, 2], [2, 32, 64, 16]]",6484,right,16,"[[0, 2, 2, 256], [0, 0, 2, 16], [4, 512, 128, 2], [2, 32, 64, 16]]",6500
17,"[[0, 2, 2, 256], [0, 0, 2, 16], [4, 512, 128, 2], [2, 32, 64, 16]]",6500,right,4,"[[0, 4, 4, 256], [0, 0, 2, 16], [4, 512, 128, 2], [2, 32, 64, 16]]",6504
17,"[[0, 4, 4, 256], [0, 0, 2, 16], [4, 512, 128, 2], [2, 32, 64, 16]]",6504,right,8,"[[0, 0, 8, 256], [0, 4, 2, 16], [4, 512, 128, 2], [2, 32, 64, 16]]",6512
17,"[[0, 0, 8, 256], [0, 4, 2, 16], [4, 512, 128, 2], [2, 32, 64, 16]]",6512,up,0,"[[4, 4, 8, 256], [2, 512, 2, 16], [0, 32, 128, 2], [4, 0, 64, 16]]",6512
17,"[[4, 4, 8, 256], [2, 512, 2, 16], [0, 32, 128, 2], [4, 0, 64, 16]]",6512,left,8,"[[8, 8, 256, 0], [2, 512, 2, 16], [32, 128, 2, 0], [4, 64, 16, 4]]",6520
17,"[[8, 8, 256, 0], [2, 512, 2, 16], [32, 128, 2, 0], [4, 64, 16, 4]]",6520,up,4,"[[8, 8, 256, 16], [2, 512, 4, 4], [32, 128, 16, 0], [4, 64, 2, 0]]",6524
17,"[[8, 8, 256, 16], [2, 512, 4, 4], [32, 128, 16, 0], [4, 64, 2, 0]]",6524,down,0,"[[8, 8, 256, 0], [2, 512, 4, 4], [32, 128, 16, 16], [4, 64, 2, 4]]",6524
17,"[[8, 8, 256, 0], [2, 512, 4, 4], [32, 128, 16, 16], [4, 64, 2, 4]]",6524,right,56,"[[0, 0, 16, 256], [2, 2, 512, 8], [0, 32, 128, 32], [4, 64, 2, 4]]",6580
17,"[[0, 0, 16, 256], [2, 2, 512, 8], [0, 32, 128, 32], [4, 64, 2, 4]]",6580,up,0,"[[2, 2, 16, 256], [4, 32, 512, 8], [0, 64, 128, 32], [0, 4, 2, 4]]",6580
17,"[[2, 2, 16, 256], [4, 32, 512, 8], [0, 64, 128, 32], [0, 4, 2, 4]]",6580,up,0,"[[2, 2, 16, 256], [4, 32, 512, 8], [4, 64, 128, 32], [0, 4, 2, 4]]",6580
17,"[[2, 2, 16, 256], [4, 32, 512, 8], [4, 64, 128, 32], [0, 4, 2, 4]]",6580,left,4,"[[4, 16, 256, 0], [4, 32, 512, 8], [4, 64, 128, 32], [4, 2, 4, 2]]",6584
17,"[[4, 16, 256, 0], [4, 32, 512, 8], [4, 64, 128, 32], [4, 2, 4, 2]]",6584,up,16,"[[8, 16, 256, 8], [8, 32, 512, 32], [0, 64, 128, 2], [0, 2, 4, 2]]",6600
17,"[[8, 16, 256, 8], [8, 32, 512, 32], [0, 64, 128, 2], [0, 2, 4, 2]]",6600,up,20,"[[16, 16, 256, 8], [4, 32, 512, 32], [0, 64, 128, 4], [0, 2, 4, 0]]",6620
17,"[[16, 16, 256, 8], [4, 32, 512, 32], [0, 64, 128, 4], [0, 2, 4, 0]]",6620,right,32,"[[0, 32, 256, 8], [4, 32, 512, 32], [0, 64, 128, 4], [0, 2, 2, 4]]",6652
17,"[[0, 32, 256, 8], [4, 32, 512, 32], [0, 64, 128, 4], [0, 2, 2, 4]]",6652,down,72,"[[0, 0, 256, 0], [0, 64, 512, 8], [2, 64, 128, 32], [4, 2, 2, 8]]",6724
17,"[[0, 0, 256, 0], [0, 64, 512, 8], [2, 64, 128, 32], [4, 2, 2, 8]]",6724,down,128,"[[0, 0, 256, 2], [0, 0, 512, 8], [2, 128, 128, 32], [4, 2, 2, 8]]",6852
17,"[[0, 0, 256, 2], [0, 0, 512, 8], [2, 128, 128, 32], [4, 2, 2, 8]]",6852,left,260,"[[256, 2, 0, 2], [512, 8, 0, 0], [2, 256, 32, 0], [4, 4, 8, 0]]",7112
17,"[[256, 2, 0, 2], [512, 8, 0, 0], [2, 256, 32, 0], [4, 4, 8, 0]]",7112,left,12,"[[256, 4, 0, 0], [512, 8, 4, 0], [2, 256, 32, 0], [8, 8, 0, 0]]",7124
17,"[[256, 4, 0, 0], [512, 8, 4, 0], [2, 256, 32, 0], [8, 8, 0, 0]]",7124,left,16,"[[256, 4, 0, 2], [512, 8, 4, 0], [2, 256, 32, 0], [16, 0, 0, 0]]",7140
17,"[[256, 4, 0, 2], [512, 8, 4, 0], [2, 256, 32, 0], [16, 0, 0, 0]]",7140,up,0,"[[256, 4, 4, 2], [512, 8, 32, 0], [2, 256, 0, 0], [16, 2, 0, 0]]",7140
17,"[[256, 4, 4, 2], [512, 8, 32, 0], [2, 256, 0, 0], [16, 2, 0, 0]]",7140,left,8,"[[256, 8, 2, 2], [512, 8, 32, 0], [2, 256, 0, 0], [16, 2, 0, 0]]",7148
17,"[[256, 8, 2, 2], [512, 8, 32, 0], [2, 256, 0, 0], [16, 2, 0, 0]]",7148,up,16,"[[256, 16, 2, 2], [512, 256, 32, 0], [2, 2, 0, 4], [16, 0, 0, 0]]",7164
17,"[[256, 16, 2, 2], [512, 256, 32, 0], [2, 2, 0, 4], [16, 0, 0, 0]]",7164,left,8,"[[256, 16, 4, 4], [512, 256, 32, 0], [4, 4, 0, 0], [16, 0, 0, 0]]",7172
17,"[[256, 16, 4, 4], [512, 256, 32, 0], [4, 4, 0, 0], [16, 0, 0, 0]]",7172,right,16,"[[4, 256, 16, 8], [0, 512, 256, 32], [0, 0, 0, 8], [0, 0, 0, 16]]",7188
17,"[[4, 256, 16, 8], [0, 512, 256, 32], [0, 0, 0, 8], [0, 0, 0, 16]]",7188,right,0,"[[4, 256, 16, 8], [0, 512, 256, 32], [0, 0, 0, 8], [0, 2, 0, 16]]",7188
17,"[[4, 256, 16, 8], [0, 512, 256, 32], [0, 0, 0, 8], [0, 2, 0, 16]]",7188,left,0,"[[4, 256, 16, 8], [512, 256, 32, 0], [8, 4, 0, 0], [2, 16, 0, 0]]",7188
17,"[[4, 256, 16, 8], [512, 256, 32, 0], [8, 4, 0, 0], [2, 16, 0, 0]]",7188,up,512,"[[4, 512, 16, 8], [512, 4, 32, 0], [8, 16, 0, 0], [2, 4, 0, 0]]",7700
17,"[[4, 512, 16, 8], [512, 4, 32, 0], [8, 16, 0, 0], [2, 4, 0, 0]]",7700,right,0,"[[4, 512, 16, 8], [0, 512, 4, 32], [0, 0, 8, 16], [0, 4, 2, 4]]",7700
17,"[[4, 512, 16, 8], [0, 512, 4, 32], [0, 0, 8, 16], [0, 4, 2, 4]]",7700,up,1024,"[[4, 1024, 16, 8], [4, 4, 4, 32], [0, 0, 8, 16], [0, 0, 2, 4]]",8724
17,"[[4, 1024, 16, 8], [4, 4, 4, 32], [0, 0, 8, 16], [0, 0, 2, 4]]",8724,right,8,"[[4, 1024, 16, 8], [2, 4, 8, 32], [0, 0, 8, 16], [0, 0, 2, 4]]",8732
17,"[[4, 1024, 16, 8], [2, 4, 8, 32], [0, 0, 8, 16], [0, 0, 2, 4]]",8732,down,16,"[[0, 0, 0, 8], [0, 2, 16, 32], [4, 1024, 16, 16], [2, 4, 2, 4]]",8748
17,"[[0, 0, 0, 8], [0, 2, 16, 32], [4, 1024, 16, 16], [2, 4, 2, 4]]",8748,right,32,"[[4, 0, 0, 8], [0, 2, 16, 32], [0, 4, 1024, 32], [2, 4, 2, 4]]",8780
17,"[[4, 0, 0, 8], [0, 2, 16, 32], [0, 4, 1024, 32], [2, 4, 2, 4]]",8780,up,72,"[[4, 2, 16, 8], [2, 8, 1024, 64], [2, 0, 2, 4], [0, 0, 0, 0]]",8852
17,"[[4, 2, 16, 8], [2, 8, 1024, 64], [2, 0, 2, 4], [0, 0, 0, 0]]",8852,up,4,"[[4, 2, 16, 8], [4, 8, 1024, 64], [0, 0, 2, 4], [4, 0, 0, 0]]",8856
17,"[[4, 2, 16, 8], [4, 8, 1024, 64], [0, 0, 2, 4], [4, 0, 0, 0]]",8856,down,8,"[[0, 0, 4, 0], [0, 0, 16, 8], [4, 2, 1024, 64], [8, 8, 2, 4]]",8864
17,"[[0, 0, 4, 0], [0, 0, 16, 8], [4, 2, 1024, 64], [8, 8, 2, 4]]",8864,left,16,"[[4, 0, 0, 0], [16, 8, 2, 0], [4, 2, 1024, 64], [16, 2, 4, 0]]",8880
17,"[[4, 0, 0, 0], [16, 8, 2, 0], [4, 2, 1024, 64], [16, 2, 4, 0]]",8880,down,4,"[[4, 0, 2, 0], [16, 0, 2, 0], [4, 8, 1024, 0], [16, 4, 4, 64]]",8884
17,"[[4, 0, 2, 0], [16, 0, 2, 0], [4, 8, 1024, 0], [16, 4, 4, 64]]",8884,right,8,"[[0, 0, 4, 2], [0, 4, 16, 2], [0, 4, 8, 1024], [0, 16, 8, 64]]",8892
17,"[[0, 0, 4, 2], [0, 4, 16, 2], [0, 4, 8, 1024], [0, 16, 8, 64]]",8892,down,28,"[[0, 2, 0, 0], [0, 0, 4, 4], [0, 8, 16, 1024], [0, 16, 16, 64]]",8920
17,"[[0, 2, 0, 0], [0, 0, 4, 4], [0, 8, 16, 1024], [0, 16, 16, 64]]",8920,left,40,"[[2, 0, 0, 0], [8, 0, 0, 0], [8, 16, 1024, 4], [32, 64, 0, 0]]",8960
17,"[[2, 0, 0, 0], [8, 0, 0, 0], [8, 16, 1024, 4], [32, 64, 0, 0]]",8960,down,16,"[[0, 0, 4, 0], [2, 0, 0, 0], [16, 16, 0, 0], [32, 64, 1024, 4]]",8976
17,"[[0, 0, 4, 0], [2, 0, 0, 0], [16, 16, 0, 0], [32, 64, 1024, 4]]",8976,left,32,"[[4, 0, 0, 4], [2, 0, 0, 0], [32, 0, 0, 0], [32, 64, 1024, 4]]",9008
17,"[[4, 0, 0, 4], [2, 0, 0, 0], [32, 0, 0, 0], [32, 64, 1024, 4]]",9008,down,72,"[[0, 0, 0, 0], [4, 0, 0, 0], [2, 0, 0, 4], [64, 64, 1024, 8]]",9080
17,"[[0, 0, 0, 0], [4, 0, 0, 0], [2, 0, 0, 4], [64, 64, 1024, 8]]",9080,right,128,"[[0, 0, 0, 0], [0, 0, 0, 4], [4, 0, 2, 4], [0, 128, 1024, 8]]",9208
17,"[[0, 0, 0, 0], [0, 0, 0, 4], [4, 0, 2, 4], [0, 128, 1024, 8]]",9208,up,8,"[[4, 128, 2, 8], [0, 4, 1024, 8], [0, 0, 0, 0], [0, 0, 0, 0]]",9216
17,"[[4, 128, 2, 8], [0, 4, 1024, 8], [0, 0, 0, 0], [0, 0, 0, 0]]",9216,down,16,"[[0, 0, 0, 0], [0, 0, 0, 0], [2, 128, 2, 0], [4, 4, 1024, 16]]",9232
17,"[[0, 0, 0, 0], [0, 0, 0, 0], [2, 128, 2, 0], [4, 4, 1024, 16]]",9232,left,8,"[[0, 0, 0, 0], [4, 0, 0, 0], [2, 128, 2, 0], [8, 1024, 16, 0]]",9240
17,"[[0, 0, 0, 0], [4, 0, 0, 0], [2, 128, 2, 0], [8, 1024, 16, 0]]",9240,up,0,"[[4, 128, 2, 0], [2, 1024, 16, 0], [8, 0, 0, 0], [0, 0, 2, 0]]",9240
17,"[[4, 128, 2, 0], [2, 1024, 16, 0], [8, 0, 0, 0], [0, 0, 2, 0]]",9240,down,0,"[[0, 0, 0, 0], [4, 0, 2, 2], [2, 128, 16, 0], [8, 1024, 2, 0]]",9240
17,"[[0, 0, 0, 0], [4, 0, 2, 2], [2, 128, 16, 0], [8, 1024, 2, 0]]",9240,right,4,"[[0, 0, 2, 0], [0, 0, 4, 4], [0, 2, 128, 16], [0, 8, 1024, 2]]",9244
17,"[[0, 0, 2, 0], [0, 0, 4, 4], [0, 2, 128, 16], [0, 8, 1024, 2]]",9244,up,0,"[[0, 2, 2, 4], [0, 8, 4, 16], [4, 0, 128, 2], [0, 0, 1024, 0]]",9244
17,"[[0, 2, 2, 4], [0, 8, 4, 16], [4, 0, 128, 2], [0, 0, 1024, 0]]",9244,right,4,"[[0, 2, 4, 4], [0, 8, 4, 16], [0, 4, 128, 2], [0, 0, 0, 1024]]",9248
17,"[[0, 2, 4, 4], [0, 8, 4, 16], [0, 4, 128, 2], [0, 0, 0, 1024]]",9248,down,8,"[[0, 0, 0, 4], [0, 2, 2, 16], [0, 8, 8, 2], [0, 4, 128, 1024]]",9256
17,"[[0, 0, 0, 4], [0, 2, 2, 16], [0, 8, 8, 2], [0, 4, 128, 1024]]",9256,right,20,"[[0, 0, 0, 4], [0, 4, 4, 16], [0, 0, 16, 2], [0, 4, 128, 1024]]",9276
17,"[[0, 0, 0, 4], [0, 4, 4, 16], [0, 0, 16, 2], [0, 4, 128, 1024]]",9276,up,8,"[[0, 8, 4, 4], [0, 0, 16, 16], [0, 0, 128, 2], [4, 0, 0, 1024]]",9284
17,"[[0, 8, 4, 4], [0, 0, 16, 16], [0, 0, 128, 2], [4, 0, 0, 1024]]",9284,right,40,"[[0, 0, 8, 8], [0, 0, 0, 32], [0, 0, 128, 2], [0, 4, 4, 1024]]",9324
17,"[[0, 0, 8, 8], [0, 0, 0, 32], [0, 0, 128, 2], [0, 4, 4, 1024]]",9324,right,24,"[[0, 0, 0, 16], [4, 0, 0, 32], [0, 0, 128, 2], [0, 0, 8, 1024]]",9348
17,"[[0, 0, 0, 16], [4, 0, 0, 32], [0, 0, 128, 2], [0, 0, 8, 1024]]",9348,up,0,"[[4, 0, 128, 16], [0, 0, 8, 32], [0, 0, 4, 2], [0, 0, 0, 1024]]",9348
17,"[[4, 0, 128, 16], [0, 0, 8, 32], [0, 0, 4, 2], [0, 0, 0, 1024]]",9348,down,0,"[[0, 0, 0, 16], [0, 0, 128, 32], [2, 0, 8, 2], [4, 0, 4, 1024]]",9348
17,"[[0, 0, 0, 16], [0, 0, 128, 32], [2, 0, 8, 2], [4, 0, 4, 1024]]",9348,right,8,"[[0, 0, 0, 16], [0, 0, 128, 32], [2, 2, 8, 2], [0, 0, 8, 1024]]",9356
17,"[[0, 0, 0, 16], [0, 0, 128, 32], [2, 2, 8, 2], [0, 0, 8, 1024]]",9356,up,16,"[[2, 2, 128, 16], [0, 0, 16, 32], [4, 0, 0, 2], [0, 0, 0, 1024]]",9372
17,"[[2, 2, 128, 16], [0, 0, 16, 32], [4, 0, 0, 2], [0, 0, 0, 1024]]",9372,right,4,"[[0, 4, 128, 16], [0, 2, 16, 32], [0, 0, 4, 2], [0, 0, 0, 1024]]",9376
17,"[[0, 4, 128, 16], [0, 2, 16, 32], [0, 0, 4, 2], [0, 0, 0, 1024]]",9376,right,0,"[[2, 4, 128, 16], [0, 2, 16, 32], [0, 0, 4, 2], [0, 0, 0, 1024]]",9376
17,"[[2, 4, 128, 16], [0, 2, 16, 32], [0, 0, 4, 2], [0, 0, 0, 1024]]",9376,left,0,"[[2, 4, 128, 16], [2, 16, 32, 0], [4, 2, 0, 4], [1024, 0, 0, 0]]",9376
17,"[[2, 4, 128, 16], [2, 16, 32, 0], [4, 2, 0, 4], [1024, 0, 0, 0]]",9376,up,4,"[[4, 4, 128, 16], [4, 16, 32, 4], [1024, 2, 0, 0], [0, 4, 0, 0]]",9380
17,"[[4, 4, 128, 16], [4, 16, 32, 4], [1024, 2, 0, 0], [0, 4, 0, 0]]",9380,left,8,"[[8, 128, 16, 0], [4, 16, 32, 4], [1024, 2, 0, 0], [4, 4, 0, 0]]",9388
17,"[[8, 128, 16, 0], [4, 16, 32, 4], [1024, 2, 0, 0], [4, 4, 0, 0]]",9388,left,8,"[[8, 128, 16, 0], [4, 16, 32, 4], [1024, 2, 2, 0], [8, 0, 0, 0]]",9396
17,"[[8, 128, 16, 0], [4, 16, 32, 4], [1024, 2, 2, 0], [8, 0, 0, 0]]",9396,right,4,"[[0, 8, 128, 16], [4, 16, 32, 4], [0, 0, 1024, 4], [0, 4, 0, 8]]",9400
17,"[[0, 8, 128, 16], [4, 16, 32, 4], [0, 0, 1024, 4], [0, 4, 0, 8]]",9400,down,8,"[[0, 0, 0, 2], [0, 8, 128, 16], [0, 16, 32, 8], [4, 4, 1024, 8]]",9408
17,"[[0, 0, 0, 2], [0, 8, 128, 16], [0, 16, 32, 8], [4, 4, 1024, 8]]",9408,down,16,"[[2, 0, 0, 0], [0, 8, 128, 2], [0, 16, 32, 16], [4, 4, 1024, 16]]",9424
17,"[[2, 0, 0, 0], [0, 8, 128, 2], [0, 16, 32, 16], [4, 4, 1024, 16]]",9424,up,32,"[[2, 8, 128, 2], [4, 16, 32, 32], [0, 4, 1024, 0], [0, 0, 4, 0]]",9456
17,"[[2, 8, 128, 2], [4, 16, 32, 32], [0, 4, 1024, 0], [0, 0, 4, 0]]",9456,right,64,"[[2, 8, 128, 2], [0, 4, 16, 64], [0, 0, 4, 1024], [4, 0, 0, 4]]",9520
17,"[[2, 8, 128, 2], [0, 4, 16, 64], [0, 0, 4, 1024], [4, 0, 0, 4]]",9520,down,0,"[[2, 0, 0, 2], [0, 0, 128, 64], [2, 8, 16, 1024], [4, 4, 4, 4]]",9520
17,"[[2, 0, 0, 2], [0, 0, 128, 64], [2, 8, 16, 1024], [4, 4, 4, 4]]",9520,left,20,"[[4, 0, 0, 0], [128, 64, 0, 0], [2, 8, 16, 1024], [8, 8, 4, 0]]",9540
17,"[[4, 0, 0, 0], [128, 64, 0, 0], [2, 8, 16, 1024], [8, 8, 4, 0]]",9540,right,16,"[[0, 0, 0, 4], [4, 0, 128, 64], [2, 8, 16, 1024], [0, 0, 16, 4]]",9556
17,"[[0, 0, 0, 4], [4, 0, 128, 64], [2, 8, 16, 1024], [0, 0, 16, 4]]",9556,up,32,"[[4, 8, 128, 4], [2, 0, 32, 64], [2, 0, 0, 1024], [0, 0, 0, 4]]",9588
17,"[[4, 8, 128, 4], [2, 0, 32, 64], [2, 0, 0, 1024], [0, 0, 0, 4]]",9588,down,4,"[[0, 0, 0, 4], [0, 2, 0, 64], [4, 0, 128, 1024], [4, 8, 32, 4]]",9592
17,"[[0, 0, 0, 4], [0, 2, 0, 64], [4, 0, 128, 1024], [4, 8, 32, 4]]",9592,down,8,"[[0, 0, 0, 4], [4, 0, 0, 64], [0, 2, 128, 1024], [8, 8, 32, 4]]",9600
17,"[[0, 0, 0, 4], [4, 0, 0, 64], [0, 2, 128, 1024], [8, 8, 32, 4]]",9600,left,16,"[[4, 0, 0, 0], [4, 64, 0, 0], [2, 128, 1024, 0], [16, 32, 4, 2]]",9616
17,"[[4, 0, 0, 0], [4, 64, 0, 0], [2, 128, 1024, 0], [16, 32, 4, 2]]",9616,down,8,"[[0, 2, 0, 0], [8, 64, 0, 0], [2, 128, 1024, 0], [16, 32, 4, 2]]",9624
17,"[[0, 2, 0, 0], [8, 64, 0, 0], [2, 128, 1024, 0], [16, 32, 4, 2]]",9624,up,0,"[[8, 2, 1024, 2], [2, 64, 4, 0], [16, 128, 0, 0], [4, 32, 0, 0]]",9624
17,"[[8, 2, 1024, 2], [2, 64, 4, 0], [16, 128, 0, 0], [4, 32, 0, 0]]",9624,right,0,"[[8, 2, 1024, 2], [0, 2, 64, 4], [2, 0, 16, 128], [0, 0, 4, 32]]",9624
17,"[[8, 2, 1024, 2], [0, 2, 64, 4], [2, 0, 16, 128], [0, 0, 4, 32]]",9624,up,4,"[[8, 4, 1024, 2], [2, 0, 64, 4], [0, 0, 16, 128], [0, 2, 4, 32]]",9628
17,"[[8, 4, 1024, 2], [2, 0, 64, 4], [0, 0, 16, 128], [0, 2, 4, 32]]",9628,down,0,"[[0, 0, 1024, 2], [2, 0, 64, 4], [8, 4, 16, 128], [2, 2, 4, 32]]",9628
17,"[[0, 0, 1024, 2], [2, 0, 64, 4], [8, 4, 16, 128], [2, 2, 4, 32]]",9628,left,4,"[[1024, 2, 0, 0], [2, 64, 4, 2], [8, 4, 16, 128], [4, 4, 32, 0]]",9632
17,"[[1024, 2, 0, 0], [2, 64, 4, 2], [8, 4, 16, 128], [4, 4, 32, 0]]",9632,up,8,"[[1024, 2, 4, 2], [2, 64, 16, 128], [8, 8, 32, 2], [4, 0, 0, 0]]",9640
17,"[[1024, 2, 4, 2], [2, 64, 16, 128], [8, 8, 32, 2], [4, 0, 0, 0]]",9640,right,16,"[[1024, 2, 4, 2], [2, 64, 16, 128], [0, 16, 32, 2], [0, 2, 0, 4]]",9656
17,"[[1024, 2, 4, 2], [2, 64, 16, 128], [0, 16, 32, 2], [0, 2, 0, 4]]",9656,down,0,"[[0, 2, 0, 2], [2, 64, 4, 128], [1024, 16, 16, 2], [2, 2, 32, 4]]",9656
17,"[[0, 2, 0, 2], [2, 64, 4, 128], [1024, 16, 16, 2], [2, 2, 32, 4]]",9656,left,40,"[[4, 0, 4, 0], [2, 64, 4, 128], [1024, 32, 2, 0], [4, 32, 4, 0]]",9696
17,"[[4, 0, 4, 0], [2, 64, 4, 128], [1024, 32, 2, 0], [4, 32, 4, 0]]",9696,down,72,"[[4, 0, 0, 4], [2, 0, 8, 0], [1024, 64, 2, 0], [4, 64, 4, 128]]",9768
17,"[[4, 0, 0, 4], [2, 0, 8, 0], [1024, 64, 2, 0], [4, 64, 4, 128]]",9768,up,128,"[[4, 128, 8, 4], [2, 0, 2, 128], [1024, 0, 4, 2], [4, 0, 0, 0]]",9896
17,"[[4, 128, 8, 4], [2, 0, 2, 128], [1024, 0, 4, 2], [4, 0, 0, 0]]",9896,left,4,"[[4, 128, 8, 4], [4, 128, 0, 0], [1024, 4, 2, 4], [4, 0, 0, 0]]",9900
17,"[[4, 128, 8, 4], [4, 128, 0, 0], [1024, 4, 2, 4], [4, 0, 0, 0]]",9900,up,272,"[[8, 256, 8, 8], [1024, 4, 2, 0], [4, 4, 0, 0], [0, 0, 0, 0]]",10172
17,"[[8, 256, 8, 8], [1024, 4, 2, 0], [4, 4, 0, 0], [0, 0, 0, 0]]",10172,left,24,"[[8, 256, 16, 0], [1024, 4, 2, 0], [8, 0, 0, 0], [0, 0, 2, 0]]",10196
17,"[[8, 256, 16, 0], [1024, 4, 2, 0], [8, 0, 0, 0], [0, 0, 2, 0]]",10196,down,4,"[[0, 0, 2, 0], [8, 0, 0, 0], [1024, 256, 16, 0], [8, 4, 4, 0]]",10200
17,"[[0, 0, 2, 0], [8, 0, 0, 0], [1024, 256, 16, 0], [8, 4, 4, 0]]",10200,right,8,"[[0, 0, 0, 2], [0, 0, 0, 8], [0, 1024, 256, 16], [2, 0, 8, 8]]",10208
17,"[[0, 0, 0, 2], [0, 0, 0, 8], [0, 1024, 256, 16], [2, 0, 8, 8]]",10208,right,16,"[[0, 0, 0, 2], [0, 0, 0, 8], [4, 1024, 256, 16], [0, 0, 2, 16]]",10224
17,"[[0, 0, 0, 2], [0, 0, 0, 8], [4, 1024, 256, 16], [0, 0, 2, 16]]",10224,up,32,"[[4, 1024, 256, 2], [2, 0, 2, 8], [0, 0, 0, 32], [0, 0, 0, 0]]",10256
17,"[[4, 1024, 256, 2], [2, 0, 2, 8], [0, 0, 0, 32], [0, 0, 0, 0]]",10256,left,4,"[[4, 1024, 256, 2], [4, 8, 2, 0], [32, 0, 0, 0], [0, 0, 0, 0]]",10260
17,"[[4, 1024, 256, 2], [4, 8, 2, 0], [32, 0, 0, 0], [0, 0, 0, 0]]",10260,up,8,"[[8, 1024, 256, 2], [32, 8, 2, 0], [0, 0, 0, 0], [2, 0, 0, 0]]",10268
17,"[[8, 1024, 256, 2], [32, 8, 2, 0], [0, 0, 0, 0], [2, 0, 0, 0]]",10268,right,0,"[[8, 1024, 256, 2], [0, 32, 8, 2], [0, 0, 0, 0], [2, 0, 0, 2]]",10268
17,"[[8, 1024, 256, 2], [0, 32, 8, 2], [0, 0, 0, 0], [2, 0, 0, 2]]",10268,right,4,"[[8, 1024, 256, 2], [0, 32, 8, 2], [0, 0, 0, 4], [0, 0, 0, 4]]",10272
17,"[[8, 1024, 256, 2], [0, 32, 8, 2], [0, 0, 0, 4], [0, 0, 0, 4]]",10272,down,12,"[[0, 0, 0, 0], [0, 2, 0, 0], [0, 1024, 256, 4], [8, 32, 8, 8]]",10284
17,"[[0, 0, 0, 0], [0, 2, 0, 0], [0, 1024, 256, 4], [8, 32, 8, 8]]",10284,left,16,"[[0, 0, 0, 0], [2, 0, 0, 2], [1024, 256, 4, 0], [8, 32, 16, 0]]",10300
17,"[[0, 0, 0, 0], [2, 0, 0, 2], [1024, 256, 4, 0], [8, 32, 16, 0]]",10300,right,4,"[[4, 0, 0, 0], [0, 0, 0, 4], [0, 1024, 256, 4], [0, 8, 32, 16]]",10304
17,"[[4, 0, 0, 0], [0, 0, 0, 4], [0, 1024, 256, 4], [0, 8, 32, 16]]",10304,down,8,"[[0, 0, 0, 0], [2, 0, 0, 0], [0, 1024, 256, 8], [4, 8, 32, 16]]",10312
17,"[[0, 0, 0, 0], [2, 0, 0, 0], [0, 1024, 256, 8], [4, 8, 32, 16]]",10312,right,0,"[[0, 0, 0, 0], [2, 0, 0, 2], [0, 1024, 256, 8], [4, 8, 32, 16]]",10312
17,"[[0, 0, 0, 0], [2, 0, 0, 2], [0, 1024, 256, 8], [4, 8, 32, 16]]",10312,right,4,"[[0, 0, 2, 0], [0, 0, 0, 4], [0, 1024, 256, 8], [4, 8, 32, 16]]",10316
17,"[[0, 0, 2, 0], [0, 0, 0, 4], [0, 1024, 256, 8], [4, 8, 32, 16]]",10316,right,0,"[[0, 2, 0, 2], [0, 0, 0, 4], [0, 1024, 256, 8], [4, 8, 32, 16]]",10316
17,"[[0, 2, 0, 2], [0, 0, 0, 4], [0, 1024, 256, 8], [4, 8, 32, 16]]",10316,right,4,"[[0, 0, 0, 4], [0, 2, 0, 4], [0, 1024, 256, 8], [4, 8, 32, 16]]",10320
17,"[[0, 0, 0, 4], [0, 2, 0, 4], [0, 1024, 256, 8], [4, 8, 32, 16]]",10320,down,8,"[[0, 0, 0, 0], [0, 2, 0, 8], [2, 1024, 256, 8], [4, 8, 32, 16]]",10328
17,"[[0, 0, 0, 0], [0, 2, 0, 8], [2, 1024, 256, 8], [4, 8, 32, 16]]",10328,down,16,"[[0, 0, 4, 0], [0, 2, 0, 0], [2, 1024, 256, 16], [4, 8, 32, 16]]",10344
17,"[[0, 0, 4, 0], [0, 2, 0, 0], [2, 1024, 256, 16], [4, 8, 32, 16]]",10344,down,32,"[[0, 0, 0, 0], [0, 2, 4, 0], [2, 1024, 256, 2], [4, 8, 32, 32]]",10376
17,"[[0, 0, 0, 0], [0, 2, 4, 0], [2, 1024, 256, 2], [4, 8, 32, 32]]",10376,left,64,"[[2, 0, 0, 0], [2, 4, 0, 0], [2, 1024, 256, 2], [4, 8, 64, 0]]",10440
17,"[[2, 0, 0, 0], [2, 4, 0, 0], [2, 1024, 256, 2], [4, 8, 64, 0]]",10440,down,4,"[[0, 4, 0, 0], [2, 4, 0, 0], [4, 1024, 256, 0], [4, 8, 64, 2]]",10444
17,"[[0, 4, 0, 0], [2, 4, 0, 0], [4, 1024, 256, 0], [4, 8, 64, 2]]",10444,down,16,"[[0, 4, 0, 0], [0, 8, 0, 0], [2, 1024, 256, 0], [8, 8, 64, 2]]",10460
17,"[[0, 4, 0, 0], [0, 8, 0, 0], [2, 1024, 256, 0], [8, 8, 64, 2]]",10460,right,16,"[[0, 0, 0, 4], [0, 0, 2, 8], [0, 2, 1024, 256], [0, 16, 64, 2]]",10476
17,"[[0, 0, 0, 4], [0, 0, 2, 8], [0, 2, 1024, 256], [0, 16, 64, 2]]",10476,left,0,"[[4, 0, 0, 0], [2, 8, 4, 0], [2, 1024, 256, 0], [16, 64, 2, 0]]",10476
17,"[[4, 0, 0, 0], [2, 8, 4, 0], [2, 1024, 256, 0], [16, 64, 2, 0]]",10476,down,4,"[[2, 0, 0, 0], [4, 8, 4, 0], [4, 1024, 256, 0], [16, 64, 2, 0]]",10480
17,"[[2, 0, 0, 0], [4, 8, 4, 0], [4, 1024, 256, 0], [16, 64, 2, 0]]",10480,left,0,"[[2, 0, 0, 0], [4, 8, 4, 0], [4, 1024, 256, 4], [16, 64, 2, 0]]",10480
17,"[[2, 0, 0, 0], [4, 8, 4, 0], [4, 1024, 256, 4], [16, 64, 2, 0]]",10480,up,8,"[[2, 8, 4, 4], [8, 1024, 256, 4], [16, 64, 2, 0], [0, 0, 0, 0]]",10488
17,"[[2, 8, 4, 4], [8, 1024, 256, 4], [16, 64, 2, 0], [0, 0, 0, 0]]",10488,left,8,"[[2, 8, 8, 0], [8, 1024, 256, 4], [16, 64, 2, 0], [0, 0, 0, 4]]",10496
17,"[[2, 8, 8, 0], [8, 1024, 256, 4], [16, 64, 2, 0], [0, 0, 0, 4]]",10496,up,8,"[[2, 8, 8, 8], [8, 1024, 256, 0], [16, 64, 2, 0], [0, 0, 4, 0]]",10504
17,"[[2, 8, 8, 8], [8, 1024, 256, 0], [16, 64, 2, 0], [0, 0, 4, 0]]",10504,right,16,"[[0, 2, 8, 16], [0, 8, 1024, 256], [0, 16, 64, 2], [2, 0, 0, 4]]",10520
17,"[[0, 2, 8, 16], [0, 8, 1024, 256], [0, 16, 64, 2], [2, 0, 0, 4]]",10520,up,0,"[[2, 2, 8, 16], [0, 8, 1024, 256], [0, 16, 64, 2], [0, 0, 4, 4]]",10520
17,"[[2, 2, 8, 16], [0, 8, 1024, 256], [0, 16, 64, 2], [0, 0, 4, 4]]",10520,left,12,"[[4, 8, 16, 4], [8, 1024, 256, 0], [16, 64, 2, 0], [8, 0, 0, 0]]",10532
17,"[[4, 8, 16, 4], [8, 1024, 256, 0], [16, 64, 2, 0], [8, 0, 0, 0]]",10532,down,0,"[[4, 0, 2, 0], [8, 8, 16, 0], [16, 1024, 256, 0], [8, 64, 2, 4]]",10532
17,"[[4, 0, 2, 0], [8, 8, 16, 0], [16, 1024, 256, 0], [8, 64, 2, 4]]",10532,left,16,"[[4, 2, 0, 0], [16, 16, 0, 4], [16, 1024, 256, 0], [8, 64, 2, 4]]",10548
17,"[[4, 2, 0, 0], [16, 16, 0, 4], [16, 1024, 256, 0], [8, 64, 2, 4]]",10548,down,40,"[[0, 2, 0, 4], [4, 16, 0, 0], [32, 1024, 256, 0], [8, 64, 2, 8]]",10588
17,"[[0, 2, 0, 4], [4, 16, 0, 0], [32, 1024, 256, 0], [8, 64, 2, 8]]",10588,down,0,"[[0, 2, 0, 0], [4, 16, 4, 0], [32, 1024, 256, 4], [8, 64, 2, 8]]",10588
17,"[[0, 2, 0, 0], [4, 16, 4, 0], [32, 1024, 256, 4], [8, 64, 2, 8]]",10588,right,0,"[[0, 0, 4, 2], [0, 4, 16, 4], [32, 1024, 256, 4], [8, 64, 2, 8]]",10588
17,"[[0, 0, 4, 2], [0, 4, 16, 4], [32, 1024, 256, 4], [8, 64, 2, 8]]",10588,down,8,"[[0, 2, 4, 0], [0, 4, 16, 2], [32, 1024, 256, 8], [8, 64, 2, 8]]",10596
17,"[[0, 2, 4, 0], [0, 4, 16, 2], [32, 1024, 256, 8], [8, 64, 2, 8]]",10596,up,16,"[[32, 2, 4, 2], [8, 4, 16, 16], [0, 1024, 256, 0], [2, 64, 2, 0]]",10612
17,"[[32, 2, 4, 2], [8, 4, 16, 16], [0, 1024, 256, 0], [2, 64, 2, 0]]",10612,right,32,"[[32, 2, 4, 2], [0, 8, 4, 32], [0, 0, 1024, 256], [4, 2, 64, 2]]",10644
17,"[[32, 2, 4, 2], [0, 8, 4, 32], [0, 0, 1024, 256], [4, 2, 64, 2]]",10644,down,8,"[[0, 4, 0, 2], [0, 2, 8, 32], [32, 8, 1024, 256], [4, 2, 64, 2]]",10652
17,"[[0, 4, 0, 2], [0, 2, 8, 32], [32, 8, 1024, 256], [4, 2, 64, 2]]",10652,left,0,"[[4, 2, 0, 2], [2, 8, 32, 0], [32, 8, 1024, 256], [4, 2, 64, 2]]",10652
17,"[[4, 2, 0, 2], [2, 8, 32, 0], [32, 8, 1024, 256], [4, 2, 64, 2]]",10652,down,16,"[[4, 0, 2, 0], [2, 2, 32, 2], [32, 16, 1024, 256], [4, 2, 64, 2]]",10668
17,"[[4, 0, 2, 0], [2, 2, 32, 2], [32, 16, 1024, 256], [4, 2, 64, 2]]",10668,left,4,"[[4, 2, 2, 0], [4, 32, 2, 0], [32, 16, 1024, 256], [4, 2, 64, 2]]",10672
17,"[[4, 2, 2, 0], [4, 32, 2, 0], [32, 16, 1024, 256], [4, 2, 64, 2]]",10672,up,12,"[[8, 2, 4, 256], [32, 32, 1024, 2], [4, 16, 64, 0], [0, 2, 0, 2]]",10684
17,"[[8, 2, 4, 256], [32, 32, 1024, 2], [4, 16, 64, 0], [0, 2, 0, 2]]",10684,left,68,"[[8, 2, 4, 256], [64, 1024, 2, 2], [4, 16, 64, 0], [4, 0, 0, 0]]",10752
17,"[[8, 2, 4, 256], [64, 1024, 2, 2], [4, 16, 64, 0], [4, 0, 0, 0]]",10752,up,8,"[[8, 2, 4, 256], [64, 1024, 2, 2], [8, 16, 64, 0], [0, 0, 4, 0]]",10760
17,"[[8, 2, 4, 256], [64, 1024, 2, 2], [8, 16, 64, 0], [0, 0, 4, 0]]",10760,left,4,"[[8, 2, 4, 256], [64, 1024, 4, 0], [8, 16, 64, 0], [4, 0, 4, 0]]",10764
17,"[[8, 2, 4, 256], [64, 1024, 4, 0], [8, 16, 64, 0], [4, 0, 4, 0]]",10764,left,8,"[[8, 2, 4, 256], [64, 1024, 4, 0], [8, 16, 64, 0], [8, 4, 0, 0]]",10772
17,"[[8, 2, 4, 256], [64, 1024, 4, 0], [8, 16, 64, 0], [8, 4, 0, 0]]",10772,up,24,"[[8, 2, 8, 256], [64, 1024, 64, 0], [16, 16, 0, 0], [0, 4, 0, 2]]",10796
17,"[[8, 2, 8, 256], [64, 1024, 64, 0], [16, 16, 0, 0], [0, 4, 0, 2]]",10796,right,32,"[[8, 2, 8, 256], [0, 64, 1024, 64], [0, 2, 0, 32], [0, 0, 4, 2]]",10828
17,"[[8, 2, 8, 256], [0, 64, 1024, 64], [0, 2, 0, 32], [0, 0, 4, 2]]",10828,down,0,"[[0, 2, 0, 256], [0, 2, 8, 64], [0, 64, 1024, 32], [8, 2, 4, 2]]",10828
17,"[[0, 2, 0, 256], [0, 2, 8, 64], [0, 64, 1024, 32], [8, 2, 4, 2]]",10828,down,4,"[[4, 0, 0, 256], [0, 4, 8, 64], [0, 64, 1024, 32], [8, 2, 4, 2]]",10832
17,"[[4, 0, 0, 256], [0, 4, 8, 64], [0, 64, 1024, 32], [8, 2, 4, 2]]",10832,up,0,"[[4, 4, 8, 256], [8, 64, 1024, 64], [4, 2, 4, 32], [0, 0, 0, 2]]",10832
17,"[[4, 4, 8, 256], [8, 64, 1024, 64], [4, 2, 4, 32], [0, 0, 0, 2]]",10832,right,8,"[[0, 8, 8, 256], [8, 64, 1024, 64], [4, 2, 4, 32], [2, 0, 0, 2]]",10840
17,"[[0, 8, 8, 256], [8, 64, 1024, 64], [4, 2, 4, 32], [2, 0, 0, 2]]",10840,left,20,"[[16, 256, 0, 0], [8, 64, 1024, 64], [4, 2, 4, 32], [4, 0, 0, 2]]",10860
17,"[[16, 256, 0, 0], [8, 64, 1024, 64], [4, 2, 4, 32], [4, 0, 0, 2]]",10860,up,8,"[[16, 256, 1024, 64], [8, 64, 4, 32], [8, 2, 0, 2], [0, 2, 0, 0]]",10868
17,"[[16, 256, 1024, 64], [8, 64, 4, 32], [8, 2, 0, 2], [0, 2, 0, 0]]",10868,down,20,"[[0, 0, 0, 2], [0, 256, 0, 64], [16, 64, 1024, 32], [16, 4, 4, 2]]",10888
17,"[[0, 0, 0, 2], [0, 256, 0, 64], [16, 64, 1024, 32], [16, 4, 4, 2]]",10888,left,8,"[[2, 2, 0, 0], [256, 64, 0, 0], [16, 64, 1024, 32], [16, 8, 2, 0]]",10896
17,"[[2, 2, 0, 0], [256, 64, 0, 0], [16, 64, 1024, 32], [16, 8, 2, 0]]",10896,down,160,"[[0, 0, 2, 0], [2, 2, 0, 0], [256, 128, 1024, 0], [32, 8, 2, 32]]",11056
17,"[[0, 0, 2, 0], [2, 2, 0, 0], [256, 128, 1024, 0], [32, 8, 2, 32]]",11056,left,4,"[[2, 0, 0, 0], [4, 0, 4, 0], [256, 128, 1024, 0], [32, 8, 2, 32]]",11060
17,"[[2, 0, 0, 0], [4, 0, 4, 0], [256, 128, 1024, 0], [32, 8, 2, 32]]",11060,left,8,"[[2, 4, 0, 0], [8, 0, 0, 0], [256, 128, 1024, 0], [32, 8, 2, 32]]",11068
17,"[[2, 4, 0, 0], [8, 0, 0, 0], [256, 128, 1024, 0], [32, 8, 2, 32]]",11068,down,0,"[[2, 0, 0, 2], [8, 4, 0, 0], [256, 128, 1024, 0], [32, 8, 2, 32]]",11068
17,"[[2, 0, 0, 2], [8, 4, 0, 0], [256, 128, 1024, 0], [32, 8, 2, 32]]",11068,right,4,"[[0, 0, 0, 4], [0, 0, 8, 4], [2, 256, 128, 1024], [32, 8, 2, 32]]",11072
17,"[[0, 0, 0, 4], [0, 0, 8, 4], [2, 256, 128, 1024], [32, 8, 2, 32]]",11072,up,8,"[[2, 256, 8, 8], [32, 8, 128, 1024], [0, 0, 2, 32], [0, 0, 4, 0]]",11080
17,"[[2, 256, 8, 8], [32, 8, 128, 1024], [0, 0, 2, 32], [0, 0, 4, 0]]",11080,right,16,"[[0, 2, 256, 16], [32, 8, 128, 1024], [0, 0, 2, 32], [0, 0, 4, 4]]",11096
17,"[[0, 2, 256, 16], [32, 8, 128, 1024], [0, 0, 2, 32], [0, 0, 4, 4]]",11096,down,0,"[[0, 0, 256, 16], [0, 2, 128, 1024], [0, 2, 2, 32], [32, 8, 4, 4]]",11096
17,"[[0, 0, 256, 16], [0, 2, 128, 1024], [0, 2, 2, 32], [32, 8, 4, 4]]",11096,right,12,"[[0, 2, 256, 16], [0, 2, 128, 1024], [0, 0, 4, 32], [0, 32, 8, 8]]",11108
17,"[[0, 2, 256, 16], [0, 2, 128, 1024], [0, 0, 4, 32], [0, 32, 8, 8]]",11108,left,16,"[[2, 256, 16, 0], [2, 128, 1024, 2], [4, 32, 0, 0], [32, 16, 0, 0]]",11124
17,"[[2, 256, 16, 0], [2, 128, 1024, 2], [4, 32, 0, 0], [32, 16, 0, 0]]",11124,up,4,"[[4, 256, 16, 2], [4, 128, 1024, 0], [32, 32, 0, 0], [0, 16, 2, 0]]",11128
17,"[[4, 256, 16, 2], [4, 128, 1024, 0], [32, 32, 0, 0], [0, 16, 2, 0]]",11128,left,64,"[[4, 256, 16, 2], [4, 128, 1024, 0], [64, 0, 0, 0], [16, 2, 2, 0]]",11192
17,"[[4, 256, 16, 2], [4, 128, 1024, 0], [64, 0, 0, 0], [16, 2, 2, 0]]",11192,up,8,"[[8, 256, 16, 2], [64, 128, 1024, 0], [16, 2, 2, 2], [0, 0, 0, 0]]",11200
17,"[[8, 256, 16, 2], [64, 128, 1024, 0], [16, 2, 2, 2], [0, 0, 0, 0]]",11200,down,4,"[[0, 0, 0, 0], [8, 256, 16, 2], [64, 128, 1024, 0], [16, 2, 2, 4]]",11204
17,"[[0, 0, 0, 0], [8, 256, 16, 2], [64, 128, 1024, 0], [16, 2, 2, 4]]",11204,left,4,"[[0, 0, 0, 2], [8, 256, 16, 2], [64, 128, 1024, 0], [16, 4, 4, 0]]",11208
17,"[[0, 0, 0, 2], [8, 256, 16, 2], [64, 128, 1024, 0], [16, 4, 4, 0]]",11208,up,4,"[[8, 256, 16, 4], [64, 128, 1024, 0], [16, 4, 4, 0], [0, 0, 4, 0]]",11212
17,"[[8, 256, 16, 4], [64, 128, 1024, 0], [16, 4, 4, 0], [0, 0, 4, 0]]",11212,left,8,"[[8, 256, 16, 4], [64, 128, 1024, 0], [16, 8, 4, 0], [4, 0, 0, 0]]",11220
17,"[[8, 256, 16, 4], [64, 128, 1024, 0], [16, 8, 4, 0], [4, 0, 0, 0]]",11220,right,0,"[[8, 256, 16, 4], [0, 64, 128, 1024], [0, 16, 8, 4], [4, 0, 0, 4]]",11220
17,"[[8, 256, 16, 4], [0, 64, 128, 1024], [0, 16, 8, 4], [4, 0, 0, 4]]",11220,up,8,"[[8, 256, 16, 4], [4, 64, 128, 1024], [0, 16, 8, 8], [0, 0, 2, 0]]",11228
17,"[[8, 256, 16, 4], [4, 64, 128, 1024], [0, 16, 8, 8], [0, 0, 2, 0]]",11228,left,16,"[[8, 256, 16, 4], [4, 64, 128, 1024], [16, 16, 0, 0], [2, 0, 2, 0]]",11244
17,"[[8, 256, 16, 4], [4, 64, 128, 1024], [16, 16, 0, 0], [2, 0, 2, 0]]",11244,right,36,"[[8, 256, 16, 4], [4, 64, 128, 1024], [0, 0, 0, 32], [0, 2, 0, 4]]",11280
17,"[[8, 256, 16, 4], [4, 64, 128, 1024], [0, 0, 0, 32], [0, 2, 0, 4]]",11280,up,0,"[[8, 256, 16, 4], [4, 64, 128, 1024], [0, 2, 0, 32], [4, 0, 0, 4]]",11280
17,"[[8, 256, 16, 4], [4, 64, 128, 1024], [0, 2, 0, 32], [4, 0, 0, 4]]",11280,up,8,"[[8, 256, 16, 4], [8, 64, 128, 1024], [0, 2, 0, 32], [0, 4, 0, 4]]",11288
17,"[[8, 256, 16, 4], [8, 64, 128, 1024], [0, 2, 0, 32], [0, 4, 0, 4]]",11288,right,8,"[[8, 256, 16, 4], [8, 64, 128, 1024], [0, 0, 2, 32], [0, 0, 2, 8]]",11296
17,"[[8, 256, 16, 4], [8, 64, 128, 1024], [0, 0, 2, 32], [0, 0, 2, 8]]",11296,up,20,"[[16, 256, 16, 4], [0, 64, 128, 1024], [4, 0, 4, 32], [0, 0, 0, 8]]",11316
17,"[[16, 256, 16, 4], [0, 64, 128, 1024], [4, 0, 4, 32], [0, 0, 0, 8]]",11316,left,8,"[[16, 256, 16, 4], [64, 128, 1024, 0], [8, 32, 0, 0], [8, 0, 0, 4]]",11324
17,"[[16, 256, 16, 4], [64, 128, 1024, 0], [8, 32, 0, 0], [8, 0, 0, 4]]",11324,down,24,"[[4, 0, 0, 0], [16, 256, 0, 0], [64, 128, 16, 0], [16, 32, 1024, 8]]",11348
17,"[[4, 0, 0, 0], [16, 256, 0, 0], [64, 128, 16, 0], [16, 32, 1024, 8]]",11348,down,0,"[[4, 0, 0, 0], [16, 256, 2, 0], [64, 128, 16, 0], [16, 32, 1024, 8]]",11348
17,"[[4, 0, 0, 0], [16, 256, 2, 0], [64, 128, 16, 0], [16, 32, 1024, 8]]",11348,left,0,"[[4, 0, 0, 4], [16, 256, 2, 0], [64, 128, 16, 0], [16, 32, 1024, 8]]",11348
17,"[[4, 0, 0, 4], [16, 256, 2, 0], [64, 128, 16, 0], [16, 32, 1024, 8]]",11348,left,8,"[[8, 0, 0, 2], [16, 256, 2, 0], [64, 128, 16, 0], [16, 32, 1024, 8]]",11356
17,"[[8, 0, 0, 2], [16, 256, 2, 0], [64, 128, 16, 0], [16, 32, 1024, 8]]",11356,down,0,"[[8, 2, 0, 0], [16, 256, 2, 0], [64, 128, 16, 2], [16, 32, 1024, 8]]",11356
17,"[[8, 2, 0, 0], [16, 256, 2, 0], [64, 128, 16, 2], [16, 32, 1024, 8]]",11356,left,0,"[[8, 2, 0, 2], [16, 256, 2, 0], [64, 128, 16, 2], [16, 32, 1024, 8]]",11356
17,"[[8, 2, 0, 2], [16, 256, 2, 0], [64, 128, 16, 2], [16, 32, 1024, 8]]",11356,right,4,"[[0, 0, 8, 4], [2, 16, 256, 2], [64, 128, 16, 2], [16, 32, 1024, 8]]",11360
17,"[[0, 0, 8, 4], [2, 16, 256, 2], [64, 128, 16, 2], [16, 32, 1024, 8]]",11360,up,4,"[[2, 16, 8, 4], [64, 128, 256, 4], [16, 32, 16, 8], [4, 0, 1024, 0]]",11364
17,"[[2, 16, 8, 4], [64, 128, 256, 4], [16, 32, 16, 8], [4, 0, 1024, 0]]",11364,up,8,"[[2, 16, 8, 8], [64, 128, 256, 8], [16, 32, 16, 2], [4, 0, 1024, 0]]",11372
17,"[[2, 16, 8, 8], [64, 128, 256, 8], [16, 32, 16, 2], [4, 0, 1024, 0]]",11372,down,16,"[[2, 0, 8, 4], [64, 16, 256, 0], [16, 128, 16, 16], [4, 32, 1024, 2]]",11388
17,"[[2, 0, 8, 4], [64, 16, 256, 0], [16, 128, 16, 16], [4, 32, 1024, 2]]",11388,left,32,"[[2, 8, 4, 0], [64, 16, 256, 0], [16, 128, 32, 2], [4, 32, 1024, 2]]",11420
17,"[[2, 8, 4, 0], [64, 16, 256, 0], [16, 128, 32, 2], [4, 32, 1024, 2]]",11420,up,4,"[[2, 8, 4, 4], [64, 16, 256, 0], [16, 128, 32, 0], [4, 32, 1024, 2]]",11424
17,"[[2, 8, 4, 4], [64, 16, 256, 0], [16, 128, 32, 0], [4, 32, 1024, 2]]",11424,left,8,"[[2, 8, 8, 2], [64, 16, 256, 0], [16, 128, 32, 0], [4, 32, 1024, 2]]",11432
17,"[[2, 8, 8, 2], [64, 16, 256, 0], [16, 128, 32, 0], [4, 32, 1024, 2]]",11432,left,16,"[[2, 16, 2, 0], [64, 16, 256, 4], [16, 128, 32, 0], [4, 32, 1024, 2]]",11448
17,"[[2, 16, 2, 0], [64, 16, 256, 4], [16, 128, 32, 0], [4, 32, 1024, 2]]",11448,up,32,"[[2, 32, 2, 4], [64, 128, 256, 2], [16, 32, 32, 0], [4, 0, 1024, 2]]",11480
17,"[[2, 32, 2, 4], [64, 128, 256, 2], [16, 32, 32, 0], [4, 0, 1024, 2]]",11480,left,64,"[[2, 32, 2, 4], [64, 128, 256, 2], [16, 64, 0, 2], [4, 1024, 2, 0]]",11544
17,"[[2, 32, 2, 4], [64, 128, 256, 2], [16, 64, 0, 2], [4, 1024, 2, 0]]",11544,down,4,"[[2, 32, 0, 2], [64, 128, 2, 0], [16, 64, 256, 4], [4, 1024, 2, 4]]",11548
17,"[[2, 32, 0, 2], [64, 128, 2, 0], [16, 64, 256, 4], [4, 1024, 2, 4]]",11548,right,0,"[[4, 2, 32, 2], [0, 64, 128, 2], [16, 64, 256, 4], [4, 1024, 2, 4]]",11548
17,"[[4, 2, 32, 2], [0, 64, 128, 2], [16, 64, 256, 4], [4, 1024, 2, 4]]",11548,up,140,"[[4, 2, 32, 4], [16, 128, 128, 8], [4, 1024, 256, 4], [0, 0, 2, 0]]",11688
17,"[[4, 2, 32, 4], [16, 128, 128, 8], [4, 1024, 256, 4], [0, 0, 2, 0]]",11688,right,256,"[[4, 2, 32, 4], [0, 16, 256, 8], [4, 1024, 256, 4], [2, 0, 0, 2]]",11944
17,"[[4, 2, 32, 4], [0, 16, 256, 8], [4, 1024, 256, 4], [2, 0, 0, 2]]",11944,down,520,"[[0, 0, 0, 4], [0, 2, 4, 8], [8, 16, 32, 4], [2, 1024, 512, 2]]",12464
17,"[[0, 0, 0, 4], [0, 2, 4, 8], [8, 16, 32, 4], [2, 1024, 512, 2]]",12464,right,0,"[[2, 0, 0, 4], [0, 2, 4, 8], [8, 16, 32, 4], [2, 1024, 512, 2]]",12464
17,"[[2, 0, 0, 4], [0, 2, 4, 8], [8, 16, 32, 4], [2, 1024, 512, 2]]",12464,left,0,"[[2, 4, 0, 0], [2, 4, 8, 2], [8, 16, 32, 4], [2, 1024, 512, 2]]",12464
17,"[[2, 4, 0, 0], [2, 4, 8, 2], [8, 16, 32, 4], [2, 1024, 512, 2]]",12464,up,12,"[[4, 8, 8, 2], [8, 16, 32, 4], [2, 1024, 512, 2], [0, 0, 4, 0]]",12476
17,"[[4, 8, 8, 2], [8, 16, 32, 4], [2, 1024, 512, 2], [0, 0, 4, 0]]",12476,left,16,"[[4, 16, 2, 0], [8, 16, 32, 4], [2, 1024, 512, 2], [4, 0, 0, 2]]",12492
17,"[[4, 16, 2, 0], [8, 16, 32, 4], [2, 1024, 512, 2], [4, 0, 0, 2]]",12492,down,36,"[[4, 0, 0, 0], [8, 4, 2, 0], [2, 32, 32, 4], [4, 1024, 512, 4]]",12528
17,"[[4, 0, 0, 0], [8, 4, 2, 0], [2, 32, 32, 4], [4, 1024, 512, 4]]",12528,right,64,"[[0, 0, 4, 4], [0, 8, 4, 2], [0, 2, 64, 4], [4, 1024, 512, 4]]",12592
17,"[[0, 0, 4, 4], [0, 8, 4, 2], [0, 2, 64, 4], [4, 1024, 512, 4]]",12592,down,16,"[[0, 0, 0, 0], [2, 8, 8, 4], [0, 2, 64, 2], [4, 1024, 512, 8]]",12608
17,"[[0, 0, 0, 0], [2, 8, 8, 4], [0, 2, 64, 2], [4, 1024, 512, 8]]",12608,left,16,"[[4, 0, 0, 0], [2, 16, 4, 0], [2, 64, 2, 0], [4, 1024, 512, 8]]",12624
17,"[[4, 0, 0, 0], [2, 16, 4, 0], [2, 64, 2, 0], [4, 1024, 512, 8]]",12624,down,4,"[[0, 0, 0, 0], [4, 16, 4, 4], [4, 64, 2, 0], [4, 1024, 512, 8]]",12628
17,"[[0, 0, 0, 0], [4, 16, 4, 4], [4, 64, 2, 0], [4, 1024, 512, 8]]",12628,up,8,"[[8, 16, 4, 4], [4, 64, 2, 8], [4, 1024, 512, 0], [0, 0, 0, 0]]",12636
17,"[[8, 16, 4, 4], [4, 64, 2, 8], [4, 1024, 512, 0], [0, 0, 0, 0]]",12636,up,8,"[[8, 16, 4, 4], [8, 64, 2, 8], [0, 1024, 512, 0], [4, 0, 0, 0]]",12644
17,"[[8, 16, 4, 4], [8, 64, 2, 8], [0, 1024, 512, 0], [4, 0, 0, 0]]",12644,up,16,"[[16, 16, 4, 4], [4, 64, 2, 8], [0, 1024, 512, 0], [4, 0, 0, 0]]",12660
17,"[[16, 16, 4, 4], [4, 64, 2, 8], [0, 1024, 512, 0], [4, 0, 0, 0]]",12660,right,40,"[[0, 4, 32, 8], [4, 64, 2, 8], [0, 0, 1024, 512], [0, 0, 0, 4]]",12700
17,"[[0, 4, 32, 8], [4, 64, 2, 8], [0, 0, 1024, 512], [0, 0, 0, 4]]",12700,up,16,"[[4, 4, 32, 16], [0, 64, 2, 512], [0, 2, 1024, 4], [0, 0, 0, 0]]",12716
17,"[[4, 4, 32, 16], [0, 64, 2, 512], [0, 2, 1024, 4], [0, 0, 0, 0]]",12716,left,8,"[[8, 32, 16, 0], [64, 2, 512, 0], [2, 1024, 4, 0], [0, 0, 2, 0]]",12724
17,"[[8, 32, 16, 0], [64, 2, 512, 0], [2, 1024, 4, 0], [0, 0, 2, 0]]",12724,left,0,"[[8, 32, 16, 0], [64, 2, 512, 0], [2, 1024, 4, 0], [2, 0, 0, 4]]",12724
17,"[[8, 32, 16, 0], [64, 2, 512, 0], [2, 1024, 4, 0], [2, 0, 0, 4]]",12724,left,0,"[[8, 32, 16, 0], [64, 2, 512, 4], [2, 1024, 4, 0], [2, 4, 0, 0]]",12724
17,"[[8, 32, 16, 0], [64, 2, 512, 4], [2, 1024, 4, 0], [2, 4, 0, 0]]",12724,down,4,"[[0, 32, 0, 0], [8, 2, 16, 0], [64, 1024, 512, 4], [4, 4, 4, 4]]",12728
17,"[[0, 32, 0, 0], [8, 2, 16, 0], [64, 1024, 512, 4], [4, 4, 4, 4]]",12728,left,16,"[[32, 0, 0, 0], [8, 2, 16, 0], [64, 1024, 512, 4], [8, 8, 4, 0]]",12744
17,"[[32, 0, 0, 0], [8, 2, 16, 0], [64, 1024, 512, 4], [8, 8, 4, 0]]",12744,right,16,"[[4, 0, 0, 32], [0, 8, 2, 16], [64, 1024, 512, 4], [0, 0, 16, 4]]",12760
17,"[[4, 0, 0, 32], [0, 8, 2, 16], [64, 1024, 512, 4], [0, 0, 16, 4]]",12760,down,8,"[[2, 0, 0, 0], [0, 0, 2, 32], [4, 8, 512, 16], [64, 1024, 16, 8]]",12768
17,"[[2, 0, 0, 0], [0, 0, 2, 32], [4, 8, 512, 16], [64, 1024, 16, 8]]",12768,right,0,"[[0, 4, 0, 2], [0, 0, 2, 32], [4, 8, 512, 16], [64, 1024, 16, 8]]",12768
17,"[[0, 4, 0, 2], [0, 0, 2, 32], [4, 8, 512, 16], [64, 1024, 16, 8]]",12768,up,0,"[[4, 4, 2, 2], [64, 8, 512, 32], [0, 1024, 16, 16], [0, 4, 0, 8]]",12768
17,"[[4, 4, 2, 2], [64, 8, 512, 32], [0, 1024, 16, 16], [0, 4, 0, 8]]",12768,right,44,"[[0, 4, 8, 4], [64, 8, 512, 32], [0, 0, 1024, 32], [0, 0, 4, 8]]",12812
17,"[[0, 4, 8, 4], [64, 8, 512, 32], [0, 0, 1024, 32], [0, 0, 4, 8]]",12812,down,64,"[[0, 0, 8, 0], [0, 4, 512, 4], [0, 4, 1024, 64], [64, 8, 4, 8]]",12876
17,"[[0, 0, 8, 0], [0, 4, 512, 4], [0, 4, 1024, 64], [64, 8, 4, 8]]",12876,up,8,"[[64, 8, 8, 4], [0, 8, 512, 64], [0, 0, 1024, 8], [0, 4, 4, 0]]",12884
17,"[[64, 8, 8, 4], [0, 8, 512, 64], [0, 0, 1024, 8], [0, 4, 4, 0]]",12884,right,24,"[[0, 64, 16, 4], [0, 8, 512, 64], [0, 4, 1024, 8], [0, 0, 0, 8]]",12908
17,"[[0, 64, 16, 4], [0, 8, 512, 64], [0, 4, 1024, 8], [0, 0, 0, 8]]",12908,up,16,"[[0, 64, 16, 4], [0, 8, 512, 64], [4, 4, 1024, 16], [0, 0, 0, 0]]",12924
17,"[[0, 64, 16, 4], [0, 8, 512, 64], [4, 4, 1024, 16], [0, 0, 0, 0]]",12924,right,8,"[[0, 64, 16, 4], [2, 8, 512, 64], [0, 8, 1024, 16], [0, 0, 0, 0]]",12932
17,"[[0, 64, 16, 4], [2, 8, 512, 64], [0, 8, 1024, 16], [0, 0, 0, 0]]",12932,down,16,"[[0, 0, 2, 0], [0, 0, 16, 4], [0, 64, 512, 64], [2, 16, 1024, 16]]",12948
17,"[[0, 0, 2, 0], [0, 0, 16, 4], [0, 64, 512, 64], [2, 16, 1024, 16]]",12948,up,0,"[[2, 64, 2, 4], [0, 16, 16, 64], [4, 0, 512, 16], [0, 0, 1024, 0]]",12948
17,"[[2, 64, 2, 4], [0, 16, 16, 64], [4, 0, 512, 16], [0, 0, 1024, 0]]",12948,left,32,"[[2, 64, 2, 4], [32, 64, 0, 0], [4, 512, 16, 0], [1024, 0, 0, 4]]",12980
17,"[[2, 64, 2, 4], [32, 64, 0, 0], [4, 512, 16, 0], [1024, 0, 0, 4]]",12980,up,136,"[[2, 128, 2, 8], [32, 512, 16, 0], [4, 0, 0, 0], [1024, 2, 0, 0]]",13116
17,"[[2, 128, 2, 8], [32, 512, 16, 0], [4, 0, 0, 0], [1024, 2, 0, 0]]",13116,right,0,"[[2, 128, 2, 8], [0, 32, 512, 16], [2, 0, 0, 4], [0, 0, 1024, 2]]",13116
17,"[[2, 128, 2, 8], [0, 32, 512, 16], [2, 0, 0, 4], [0, 0, 1024, 2]]",13116,down,4,"[[0, 0, 4, 8], [0, 0, 2, 16], [0, 128, 512, 4], [4, 32, 1024, 2]]",13120
17,"[[0, 0, 4, 8], [0, 0, 2, 16], [0, 128, 512, 4], [4, 32, 1024, 2]]",13120,right,0,"[[0, 0, 4, 8], [4, 0, 2, 16], [0, 128, 512, 4], [4, 32, 1024, 2]]",13120
17,"[[0, 0, 4, 8], [4, 0, 2, 16], [0, 128, 512, 4], [4, 32, 1024, 2]]",13120,down,8,"[[0, 0, 4, 8], [0, 0, 2, 16], [2, 128, 512, 4], [8, 32, 1024, 2]]",13128
17,"[[0, 0, 4, 8], [0, 0, 2, 16], [2, 128, 512, 4], [8, 32, 1024, 2]]",13128,left,0,"[[4, 8, 0, 0], [2, 16, 4, 0], [2, 128, 512, 4], [8, 32, 1024, 2]]",13128
17,"[[4, 8, 0, 0], [2, 16, 4, 0], [2, 128, 512, 4], [8, 32, 1024, 2]]",13128,up,4,"[[4, 8, 4, 4], [4, 16, 512, 2], [8, 128, 1024, 0], [4, 32, 0, 0]]",13132
17,"[[4, 8, 4, 4], [4, 16, 512, 2], [8, 128, 1024, 0], [4, 32, 0, 0]]",13132,left,8,"[[4, 8, 8, 0], [4, 16, 512, 2], [8, 128, 1024, 2], [4, 32, 0, 0]]",13140
17,"[[4, 8, 8, 0], [4, 16, 512, 2], [8, 128, 1024, 2], [4, 32, 0, 0]]",13140,left,16,"[[4, 16, 0, 2], [4, 16, 512, 2], [8, 128, 1024, 2], [4, 32, 0, 0]]",13156
17,"[[4, 16, 0, 2], [4, 16, 512, 2], [8, 128, 1024, 2], [4, 32, 0, 0]]",13156,up,44,"[[8, 32, 512, 4], [8, 128, 1024, 2], [4, 32, 0, 0], [0, 4, 0, 0]]",13200
17,"[[8, 32, 512, 4], [8, 128, 1024, 2], [4, 32, 0, 0], [0, 4, 0, 0]]",13200,down,16,"[[2, 32, 0, 0], [0, 128, 0, 0], [16, 32, 512, 4], [4, 4, 1024, 2]]",13216
17,"[[2, 32, 0, 0], [0, 128, 0, 0], [16, 32, 512, 4], [4, 4, 1024, 2]]",13216,left,8,"[[2, 32, 0, 0], [128, 2, 0, 0], [16, 32, 512, 4], [8, 1024, 2, 0]]",13224
17,"[[2, 32, 0, 0], [128, 2, 0, 0], [16, 32, 512, 4], [8, 1024, 2, 0]]",13224,up,0,"[[2, 32, 512, 4], [128, 2, 2, 2], [16, 32, 0, 0], [8, 1024, 0, 0]]",13224
17,"[[2, 32, 512, 4], [128, 2, 2, 2], [16, 32, 0, 0], [8, 1024, 0, 0]]",13224,right,4,"[[2, 32, 512, 4], [4, 128, 2, 4], [0, 0, 16, 32], [0, 0, 8, 1024]]",13228
17,"[[2, 32, 512, 4], [4, 128, 2, 4], [0, 0, 16, 32], [0, 0, 8, 1024]]",13228,down,8,"[[0, 0, 512, 4], [0, 0, 2, 8], [2, 32, 16, 32], [4, 128, 8, 1024]]",13236
17,"[[0, 0, 512, 4], [0, 0, 2, 8], [2, 32, 16, 32], [4, 128, 8, 1024]]",13236,left,0,"[[512, 4, 0, 0], [2, 8, 0, 4], [2, 32, 16, 32], [4, 128, 8, 1024]]",13236
17,"[[512, 4, 0, 0], [2, 8, 0, 4], [2, 32, 16, 32], [4, 128, 8, 1024]]",13236,up,4,"[[512, 4, 16, 4], [4, 8, 8, 32], [4, 32, 4, 1024], [0, 128, 0, 0]]",13240
17,"[[512, 4, 16, 4], [4, 8, 8, 32], [4, 32, 4, 1024], [0, 128, 0, 0]]",13240,right,16,"[[512, 4, 16, 4], [0, 4, 16, 32], [4, 32, 4, 1024], [0, 0, 2, 128]]",13256
17,"[[512, 4, 16, 4], [0, 4, 16, 32], [4, 32, 4, 1024], [0, 0, 2, 128]]",13256,down,40,"[[0, 0, 0, 4], [0, 2, 32, 32], [512, 8, 4, 1024], [4, 32, 2, 128]]",13296
17,"[[0, 0, 0, 4], [0, 2, 32, 32], [512, 8, 4, 1024], [4, 32, 2, 128]]",13296,right,64,"[[0, 0, 0, 4], [0, 4, 2, 64], [512, 8, 4, 1024], [4, 32, 2, 128]]",13360
17,"[[0, 0, 0, 4], [0, 4, 2, 64], [512, 8, 4, 1024], [4, 32, 2, 128]]",13360,right,0,"[[0, 4, 0, 4], [0, 4, 2, 64], [512, 8, 4, 1024], [4, 32, 2, 128]]",13360
17,"[[0, 4, 0, 4], [0, 4, 2, 64], [512, 8, 4, 1024], [4, 32, 2, 128]]",13360,up,8,"[[512, 8, 2, 4], [4, 8, 4, 64], [2, 32, 2, 1024], [0, 0, 0, 128]]",13368
17,"[[512, 8, 2, 4], [4, 8, 4, 64], [2, 32, 2, 1024], [0, 0, 0, 128]]",13368,up,16,"[[512, 16, 2, 4], [4, 32, 4, 64], [2, 0, 2, 1024], [0, 0, 2, 128]]",13384
17,"[[512, 16, 2, 4], [4, 32, 4, 64], [2, 0, 2, 1024], [0, 0, 2, 128]]",13384,right,4,"[[512, 16, 2, 4], [4, 32, 4, 64], [2, 0, 4, 1024], [0, 0, 2, 128]]",13388
17,"[[512, 16, 2, 4], [4, 32, 4, 64], [2, 0, 4, 1024], [0, 0, 2, 128]]",13388,down,8,"[[0, 0, 0, 4], [512, 4, 2, 64], [4, 16, 8, 1024], [2, 32, 2, 128]]",13396
17,"[[0, 0, 0, 4], [512, 4, 2, 64], [4, 16, 8, 1024], [2, 32, 2, 128]]",13396,down,0,"[[0, 2, 0, 4], [512, 4, 2, 64], [4, 16, 8, 1024], [2, 32, 2, 128]]",13396
17,"[[0, 2, 0, 4], [512, 4, 2, 64], [4, 16, 8, 1024], [2, 32, 2, 128]]",13396,up,0,"[[512, 2, 2, 4], [4, 4, 8, 64], [2, 16, 2, 1024], [0, 32, 4, 128]]",13396
17,"[[512, 2, 2, 4], [4, 4, 8, 64], [2, 16, 2, 1024], [0, 32, 4, 128]]",13396,right,12,"[[0, 512, 4, 4], [0, 8, 8, 64], [2, 16, 2, 1024], [2, 32, 4, 128]]",13408
17,"[[0, 512, 4, 4], [0, 8, 8, 64], [2, 16, 2, 1024], [2, 32, 4, 128]]",13408,left,24,"[[512, 8, 0, 2], [16, 64, 0, 0], [2, 16, 2, 1024], [2, 32, 4, 128]]",13432
17,"[[512, 8, 0, 2], [16, 64, 0, 0], [2, 16, 2, 1024], [2, 32, 4, 128]]",13432,down,4,"[[0, 8, 4, 0], [512, 64, 0, 2], [16, 16, 2, 1024], [4, 32, 4, 128]]",13436
17,"[[0, 8, 4, 0], [512, 64, 0, 2], [16, 16, 2, 1024], [4, 32, 4, 128]]",13436,right,32,"[[0, 0, 8, 4], [0, 512, 64, 2], [2, 32, 2, 1024], [4, 32, 4, 128]]",13468
17,"[[0, 0, 8, 4], [0, 512, 64, 2], [2, 32, 2, 1024], [4, 32, 4, 128]]",13468,left,0,"[[8, 4, 0, 4], [512, 64, 2, 0], [2, 32, 2, 1024], [4, 32, 4, 128]]",13468
17,"[[8, 4, 0, 4], [512, 64, 2, 0], [2, 32, 2, 1024], [4, 32, 4, 128]]",13468,up,68,"[[8, 4, 4, 4], [512, 64, 4, 1024], [2, 64, 0, 128], [4, 2, 0, 0]]",13536
17,"[[8, 4, 4, 4], [512, 64, 4, 1024], [2, 64, 0, 128], [4, 2, 0, 0]]",13536,up,136,"[[8, 4, 8, 4], [512, 128, 0, 1024], [2, 2, 0, 128], [4, 0, 4, 0]]",13672
17,"[[8, 4, 8, 4], [512, 128, 0, 1024], [2, 2, 0, 128], [4, 0, 4, 0]]",13672,left,12,"[[8, 4, 8, 4], [512, 128, 1024, 0], [4, 128, 4, 0], [8, 0, 0, 0]]",13684
17,"[[8, 4, 8, 4], [512, 128, 1024, 0], [4, 128, 4, 0], [8, 0, 0, 0]]",13684,down,256,"[[8, 0, 0, 4], [512, 0, 8, 0], [4, 4, 1024, 0], [8, 256, 4, 4]]",13940
17,"[[8, 0, 0, 4], [512, 0, 8, 0], [4, 4, 1024, 0], [8, 256, 4, 4]]",13940,left,16,"[[8, 4, 0, 0], [512, 8, 0, 0], [8, 1024, 0, 2], [8, 256, 8, 0]]",13956
17,"[[8, 4, 0, 0], [512, 8, 0, 0], [8, 1024, 0, 2], [8, 256, 8, 0]]",13956,down,16,"[[0, 4, 0, 0], [8, 8, 0, 0], [512, 1024, 2, 0], [16, 256, 8, 2]]",13972
17,"[[0, 4, 0, 0], [8, 8, 0, 0], [512, 1024, 2, 0], [16, 256, 8, 2]]",13972,up,0,"[[8, 4, 2, 2], [512, 8, 8, 0], [16, 1024, 0, 0], [0, 256, 2, 0]]",13972
17,"[[8, 4, 2, 2], [512, 8, 8, 0], [16, 1024, 0, 0], [0, 256, 2, 0]]",13972,left,20,"[[8, 4, 4, 0], [512, 16, 0, 0], [16, 1024, 0, 2], [256, 2, 0, 0]]",13992
17,"[[8, 4, 4, 0], [512, 16, 0, 0], [16, 1024, 0, 2], [256, 2, 0, 0]]",13992,right,8,"[[0, 0, 8, 8], [0, 2, 512, 16], [0, 16, 1024, 2], [0, 0, 256, 2]]",14000
17,"[[0, 0, 8, 8], [0, 2, 512, 16], [0, 16, 1024, 2], [0, 0, 256, 2]]",14000,right,16,"[[0, 0, 0, 16], [0, 2, 512, 16], [4, 16, 1024, 2], [0, 0, 256, 2]]",14016
17,"[[0, 0, 0, 16], [0, 2, 512, 16], [4, 16, 1024, 2], [0, 0, 256, 2]]",14016,up,36,"[[4, 2, 512, 32], [0, 16, 1024, 4], [0, 0, 256, 0], [0, 0, 0, 2]]",14052
17,"[[4, 2, 512, 32], [0, 16, 1024, 4], [0, 0, 256, 0], [0, 0, 0, 2]]",14052,down,0,"[[0, 0, 2, 0], [0, 0, 512, 32], [0, 2, 1024, 4], [4, 16, 256, 2]]",14052
17,"[[0, 0, 2, 0], [0, 0, 512, 32], [0, 2, 1024, 4], [4, 16, 256, 2]]",14052,up,0,"[[4, 2, 2, 32], [0, 16, 512, 4], [0, 0, 1024, 2], [0, 0, 256, 4]]",14052
17,"[[4, 2, 2, 32], [0, 16, 512, 4], [0, 0, 1024, 2], [0, 0, 256, 4]]",14052,left,4,"[[4, 4, 32, 0], [16, 512, 4, 0], [1024, 2, 4, 0], [256, 4, 0, 0]]",14056
17,"[[4, 4, 32, 0], [16, 512, 4, 0], [1024, 2, 4, 0], [256, 4, 0, 0]]",14056,left,8,"[[8, 32, 0, 0], [16, 512, 4, 0], [1024, 2, 4, 0], [256, 4, 2, 0]]",14064
17,"[[8, 32, 0, 0], [16, 512, 4, 0], [1024, 2, 4, 0], [256, 4, 2, 0]]",14064,up,8,"[[8, 32, 8, 0], [16, 512, 2, 0], [1024, 2, 0, 0], [256, 4, 0, 2]]",14072
17,"[[8, 32, 8, 0], [16, 512, 2, 0], [1024, 2, 0, 0], [256, 4, 0, 2]]",14072,down,0,"[[8, 32, 0, 0], [16, 512, 0, 2], [1024, 2, 8, 0], [256, 4, 2, 2]]",14072
17,"[[8, 32, 0, 0], [16, 512, 0, 2], [1024, 2, 8, 0], [256, 4, 2, 2]]",14072,right,4,"[[0, 0, 8, 32], [0, 16, 512, 2], [0, 1024, 2, 8], [2, 256, 4, 4]]",14076
17,"[[0, 0, 8, 32], [0, 16, 512, 2], [0, 1024, 2, 8], [2, 256, 4, 4]]",14076,left,8,"[[8, 32, 0, 0], [16, 512, 2, 0], [1024, 2, 8, 2], [2, 256, 8, 0]]",14084
17,"[[8, 32, 0, 0], [16, 512, 2, 0], [1024, 2, 8, 2], [2, 256, 8, 0]]",14084,up,16,"[[8, 32, 2, 2], [16, 512, 16, 0], [1024, 2, 0, 0], [2, 256, 0, 2]]",14100
17,"[[8, 32, 2, 2], [16, 512, 16, 0], [1024, 2, 0, 0], [2, 256, 0, 2]]",14100,down,4,"[[8, 32, 0, 0], [16, 512, 0, 0], [1024, 2, 2, 4], [2, 256, 16, 4]]",14104
17,"[[8, 32, 0, 0], [16, 512, 0, 0], [1024, 2, 2, 4], [2, 256, 16, 4]]",14104,right,4,"[[0, 2, 8, 32], [0, 0, 16, 512], [0, 1024, 4, 4], [2, 256, 16, 4]]",14108
17,"[[0, 2, 8, 32], [0, 0, 16, 512], [0, 1024, 4, 4], [2, 256, 16, 4]]",14108,up,8,"[[2, 2, 8, 32], [0, 1024, 16, 512], [0, 256, 4, 8], [2, 0, 16, 0]]",14116
17,"[[2, 2, 8, 32], [0, 1024, 16, 512], [0, 256, 4, 8], [2, 0, 16, 0]]",14116,right,4,"[[0, 4, 8, 32], [0, 1024, 16, 512], [2, 256, 4, 8], [0, 0, 2, 16]]",14120
17,"[[0, 4, 8, 32], [0, 1024, 16, 512], [2, 256, 4, 8], [0, 0, 2, 16]]",14120,down,0,"[[0, 0, 8, 32], [2, 4, 16, 512], [0, 1024, 4, 8], [2, 256, 2, 16]]",14120
17,"[[0, 0, 8, 32], [2, 4, 16, 512], [0, 1024, 4, 8], [2, 256, 2, 16]]",14120,up,4,"[[4, 4, 8, 32], [0, 1024, 16, 512], [0, 256, 4, 8], [0, 2, 2, 16]]",14124
17,"[[4, 4, 8, 32], [0, 1024, 16, 512], [0, 256, 4, 8], [0, 2, 2, 16]]",14124,right,12,"[[2, 8, 8, 32], [0, 1024, 16, 512], [0, 256, 4, 8], [0, 0, 4, 16]]",14136
17,"[[2, 8, 8, 32], [0, 1024, 16, 512], [0, 256, 4, 8], [0, 0, 4, 16]]",14136,left,16,"[[2, 16, 32, 0], [1024, 16, 512, 0], [256, 4, 8, 4], [4, 16, 0, 0]]",14152
17,"[[2, 16, 32, 0], [1024, 16, 512, 0], [256, 4, 8, 4], [4, 16, 0, 0]]",14152,up,32,"[[2, 32, 32, 4], [1024, 4, 512, 0], [256, 16, 8, 0], [4, 4, 0, 0]]",14184
17,"[[2, 32, 32, 4], [1024, 4, 512, 0], [256, 16, 8, 0], [4, 4, 0, 0]]",14184,right,72,"[[0, 2, 64, 4], [0, 1024, 4, 512], [0, 256, 16, 8], [0, 0, 4, 8]]",14256
17,"[[0, 2, 64, 4], [0, 1024, 4, 512], [0, 256, 16, 8], [0, 0, 4, 8]]",14256,up,16,"[[0, 2, 64, 4], [0, 1024, 4, 512], [0, 256, 16, 16], [0, 0, 4, 2]]",14272
17,"[[0, 2, 64, 4], [0, 1024, 4, 512], [0, 256, 16, 16], [0, 0, 4, 2]]",14272,left,32,"[[2, 64, 4, 0], [1024, 4, 512, 0], [256, 32, 0, 0], [4, 2, 2, 0]]",14304
17,"[[2, 64, 4, 0], [1024, 4, 512, 0], [256, 32, 0, 0], [4, 2, 2, 0]]",14304,left,4,"[[2, 64, 4, 2], [1024, 4, 512, 0], [256, 32, 0, 0], [4, 4, 0, 0]]",14308
17,"[[2, 64, 4, 2], [1024, 4, 512, 0], [256, 32, 0, 0], [4, 4, 0, 0]]",14308,right,8,"[[2, 64, 4, 2], [0, 1024, 4, 512], [4, 0, 256, 32], [0, 0, 0, 8]]",14316
17,"[[2, 64, 4, 2], [0, 1024, 4, 512], [4, 0, 256, 32], [0, 0, 0, 8]]",14316,right,0,"[[2, 64, 4, 2], [0, 1024, 4, 512], [0, 4, 256, 32], [0, 0, 4, 8]]",14316
17,"[[2, 64, 4, 2], [0, 1024, 4, 512], [0, 4, 256, 32], [0, 0, 4, 8]]",14316,down,8,"[[4, 0, 0, 2], [0, 64, 8, 512], [0, 1024, 256, 32], [2, 4, 4, 8]]",14324
17,"[[4, 0, 0, 2], [0, 64, 8, 512], [0, 1024, 256, 32], [2, 4, 4, 8]]",14324,right,8,"[[0, 4, 4, 2], [0, 64, 8, 512], [0, 1024, 256, 32], [0, 2, 8, 8]]",14332
17,"[[0, 4, 4, 2], [0, 64, 8, 512], [0, 1024, 256, 32], [0, 2, 8, 8]]",14332,right,24,"[[4, 0, 8, 2], [0, 64, 8, 512], [0, 1024, 256, 32], [0, 0, 2, 16]]",14356
17,"[[4, 0, 8, 2], [0, 64, 8, 512], [0, 1024, 256, 32], [0, 0, 2, 16]]",14356,up,16,"[[4, 64, 16, 2], [0, 1024, 256, 512], [0, 0, 2, 32], [0, 0, 4, 16]]",14372
17,"[[4, 64, 16, 2], [0, 1024, 256, 512], [0, 0, 2, 32], [0, 0, 4, 16]]",14372,right,0,"[[4, 64, 16, 2], [0, 1024, 256, 512], [0, 0, 2, 32], [0, 2, 4, 16]]",14372
17,"[[4, 64, 16, 2], [0, 1024, 256, 512], [0, 0, 2, 32], [0, 2, 4, 16]]",14372,up,0,"[[4, 64, 16, 2], [0, 1024, 256, 512], [0, 2, 2, 32], [0, 4, 4, 16]]",14372
17,"[[4, 64, 16, 2], [0, 1024, 256, 512], [0, 2, 2, 32], [0, 4, 4, 16]]",14372,right,12,"[[4, 64, 16, 2], [2, 1024, 256, 512], [0, 0, 4, 32], [0, 0, 8, 16]]",14384
17,"[[4, 64, 16, 2], [2, 1024, 256, 512], [0, 0, 4, 32], [0, 0, 8, 16]]",14384,right,0,"[[4, 64, 16, 2], [2, 1024, 256, 512], [0, 2, 4, 32], [0, 0, 8, 16]]",14384
17,"[[4, 64, 16, 2], [2, 1024, 256, 512], [0, 2, 4, 32], [0, 0, 8, 16]]",14384,left,0,"[[4, 64, 16, 2], [2, 1024, 256, 512], [2, 4, 32, 4], [8, 16, 0, 0]]",14384
17,"[[4, 64, 16, 2], [2, 1024, 256, 512], [2, 4, 32, 4], [8, 16, 0, 0]]",14384,down,4,"[[0, 64, 2, 0], [4, 1024, 16, 2], [4, 4, 256, 512], [8, 16, 32, 4]]",14388
17,"[[0, 64, 2, 0], [4, 1024, 16, 2], [4, 4, 256, 512], [8, 16, 32, 4]]",14388,down,8,"[[0, 64, 2, 2], [0, 1024, 16, 2], [8, 4, 256, 512], [8, 16, 32, 4]]",14396
17,"[[0, 64, 2, 2], [0, 1024, 16, 2], [8, 4, 256, 512], [8, 16, 32, 4]]",14396,down,20,"[[0, 64, 2, 0], [2, 1024, 16, 4], [0, 4, 256, 512], [16, 16, 32, 4]]",14416
17,"[[0, 64, 2, 0], [2, 1024, 16, 4], [0, 4, 256, 512], [16, 16, 32, 4]]",14416,left,32,"[[64, 2, 2, 0], [2, 1024, 16, 4], [4, 256, 512, 0], [32, 32, 4, 0]]",14448
17,"[[64, 2, 2, 0], [2, 1024, 16, 4], [4, 256, 512, 0], [32, 32, 4, 0]]",14448,right,68,"[[0, 0, 64, 4], [2, 1024, 16, 4], [4, 4, 256, 512], [0, 0, 64, 4]]",14516
17,"[[0, 0, 64, 4], [2, 1024, 16, 4], [4, 4, 256, 512], [0, 0, 64, 4]]",14516,up,8,"[[2, 1024, 64, 8], [4, 4, 16, 512], [0, 0, 256, 4], [0, 0, 64, 4]]",14524
17,"[[2, 1024, 64, 8], [4, 4, 16, 512], [0, 0, 256, 4], [0, 0, 64, 4]]",14524,right,8,"[[2, 1024, 64, 8], [0, 8, 16, 512], [0, 0, 256, 4], [4, 0, 64, 4]]",14532
17,"[[2, 1024, 64, 8], [0, 8, 16, 512], [0, 0, 256, 4], [4, 0, 64, 4]]",14532,up,8,"[[2, 1024, 64, 8], [4, 8, 16, 512], [0, 0, 256, 8], [0, 0, 64, 4]]",14540
17,"[[2, 1024, 64, 8], [4, 8, 16, 512], [0, 0, 256, 8], [0, 0, 64, 4]]",14540,left,0,"[[2, 1024, 64, 8], [4, 8, 16, 512], [256, 8, 2, 0], [64, 4, 0, 0]]",14540
17,"[[2, 1024, 64, 8], [4, 8, 16, 512], [256, 8, 2, 0], [64, 4, 0, 0]]",14540,up,16,"[[2, 1024, 64, 8], [4, 16, 16, 512], [256, 4, 2, 0], [64, 0, 0, 4]]",14556
17,"[[2, 1024, 64, 8], [4, 16, 16, 512], [256, 4, 2, 0], [64, 0, 0, 4]]",14556,left,32,"[[2, 1024, 64, 8], [4, 32, 512, 0], [256, 4, 2, 0], [64, 4, 0, 4]]",14588
17,"[[2, 1024, 64, 8], [4, 32, 512, 0], [256, 4, 2, 0], [64, 4, 0, 4]]",14588,up,8,"[[2, 1024, 64, 8], [4, 32, 512, 4], [256, 8, 2, 2], [64, 0, 0, 0]]",14596
17,"[[2, 1024, 64, 8], [4, 32, 512, 4], [256, 8, 2, 2], [64, 0, 0, 0]]",14596,right,4,"[[2, 1024, 64, 8], [4, 32, 512, 4], [0, 256, 8, 4], [0, 0, 2, 64]]",14600
17,"[[2, 1024, 64, 8], [4, 32, 512, 4], [0, 256, 8, 4], [0, 0, 2, 64]]",14600,down,8,"[[0, 0, 64, 2], [0, 1024, 512, 8], [2, 32, 8, 8], [4, 256, 2, 64]]",14608
17,"[[0, 0, 64, 2], [0, 1024, 512, 8], [2, 32, 8, 8], [4, 256, 2, 64]]",14608,up,16,"[[2, 1024, 64, 2], [4, 32, 512, 16], [2, 256, 8, 64], [0, 0, 2, 0]]",14624
17,"[[2, 1024, 64, 2], [4, 32, 512, 16], [2, 256, 8, 64], [0, 0, 2, 0]]",14624,left,0,"[[2, 1024, 64, 2], [4, 32, 512, 16], [2, 256, 8, 64], [2, 2, 0, 0]]",14624
17,"[[2, 1024, 64, 2], [4, 32, 512, 16], [2, 256, 8, 64], [2, 2, 0, 0]]",14624,down,4,"[[0, 1024, 2, 0], [2, 32, 64, 2], [4, 256, 512, 16], [4, 2, 8, 64]]",14628
17,"[[0, 1024, 2, 0], [2, 32, 64, 2], [4, 256, 512, 16], [4, 2, 8, 64]]",14628,up,8,"[[2, 1024, 2, 2], [8, 32, 64, 16], [4, 256, 512, 64], [0, 2, 8, 0]]",14636
17,"[[2, 1024, 2, 2], [8, 32, 64, 16], [4, 256, 512, 64], [0, 2, 8, 0]]",14636,left,4,"[[2, 1024, 4, 4], [8, 32, 64, 16], [4, 256, 512, 64], [2, 8, 0, 0]]",14640
17,"[[2, 1024, 4, 4], [8, 32, 64, 16], [4, 256, 512, 64], [2, 8, 0, 0]]",14640,left,8,"[[2, 1024, 8, 0], [8, 32, 64, 16], [4, 256, 512, 64], [2, 8, 0, 4]]",14648
17,"[[2, 1024, 8, 0], [8, 32, 64, 16], [4, 256, 512, 64], [2, 8, 0, 4]]",14648,up,0,"[[2, 1024, 8, 16], [8, 32, 64, 64], [4, 256, 512, 4], [2, 8, 2, 0]]",14648
17,"[[2, 1024, 8, 16], [8, 32, 64, 64], [4, 256, 512, 4], [2, 8, 2, 0]]",14648,left,128,"[[2, 1024, 8, 16], [8, 32, 128, 0], [4, 256, 512, 4], [2, 8, 2, 2]]",14776
17,"[[2, 1024, 8, 16], [8, 32, 128, 0], [4, 256, 512, 4], [2, 8, 2, 2]]",14776,right,4,"[[2, 1024, 8, 16], [0, 8, 32, 128], [4, 256, 512, 4], [4, 2, 8, 4]]",14780
17,"[[2, 1024, 8, 16], [0, 8, 32, 128], [4, 256, 512, 4], [4, 2, 8, 4]]",14780,up,16,"[[2, 1024, 8, 16], [8, 8, 32, 128], [0, 256, 512, 8], [2, 2, 8, 0]]",14796
17,"[[2, 1024, 8, 16], [8, 8, 32, 128], [0, 256, 512, 8], [2, 2, 8, 0]]",14796,right,20,"[[2, 1024, 8, 16], [0, 16, 32, 128], [4, 256, 512, 8], [0, 0, 4, 8]]",14816
17,"[[2, 1024, 8, 16], [0, 16, 32, 128], [4, 256, 512, 8], [0, 0, 4, 8]]",14816,down,16,"[[0, 0, 8, 0], [2, 1024, 32, 16], [2, 16, 512, 128], [4, 256, 4, 16]]",14832
17,"[[0, 0, 8, 0], [2, 1024, 32, 16], [2, 16, 512, 128], [4, 256, 4, 16]]",14832,up,4,"[[4, 1024, 8, 16], [4, 16, 32, 128], [0, 256, 512, 16], [2, 0, 4, 0]]",14836
17,"[[4, 1024, 8, 16], [4, 16, 32, 128], [0, 256, 512, 16], [2, 0, 4, 0]]",14836,left,0,"[[4, 1024, 8, 16], [4, 16, 32, 128], [256, 512, 16, 2], [2, 4, 0, 0]]",14836
17,"[[4, 1024, 8, 16], [4, 16, 32, 128], [256, 512, 16, 2], [2, 4, 0, 0]]",14836,up,8,"[[8, 1024, 8, 16], [256, 16, 32, 128], [2, 512, 16, 2], [0, 4, 0, 4]]",14844
17,"[[8, 1024, 8, 16], [256, 16, 32, 128], [2, 512, 16, 2], [0, 4, 0, 4]]",14844,left,8,"[[8, 1024, 8, 16], [256, 16, 32, 128], [2, 512, 16, 2], [8, 0, 2, 0]]",14852
17,"[[8, 1024, 8, 16], [256, 16, 32, 128], [2, 512, 16, 2], [8, 0, 2, 0]]",14852,down,0,"[[8, 4, 8, 0], [256, 1024, 32, 16], [2, 16, 16, 128], [8, 512, 2, 2]]",14852
17,"[[8, 4, 8, 0], [256, 1024, 32, 16], [2, 16, 16, 128], [8, 512, 2, 2]]",14852,right,36,"[[0, 8, 4, 8], [256, 1024, 32, 16], [4, 2, 32, 128], [0, 8, 512, 4]]",14888
17,"[[0, 8, 4, 8], [256, 1024, 32, 16], [4, 2, 32, 128], [0, 8, 512, 4]]",14888,down,64,"[[0, 8, 0, 8], [2, 1024, 4, 16], [256, 2, 64, 128], [4, 8, 512, 4]]",14952
17,"[[0, 8, 0, 8], [2, 1024, 4, 16], [256, 2, 64, 128], [4, 8, 512, 4]]",14952,right,16,"[[0, 0, 4, 16], [2, 1024, 4, 16], [256, 2, 64, 128], [4, 8, 512, 4]]",14968
17,"[[0, 0, 4, 16], [2, 1024, 4, 16], [256, 2, 64, 128], [4, 8, 512, 4]]",14968,up,40,"[[2, 1024, 8, 32], [256, 2, 64, 128], [4, 8, 512, 4], [2, 0, 0, 0]]",15008
17,"[[2, 1024, 8, 32], [256, 2, 64, 128], [4, 8, 512, 4], [2, 0, 0, 0]]",15008,right,0,"[[2, 1024, 8, 32], [256, 2, 64, 128], [4, 8, 512, 4], [0, 0, 4, 2]]",15008
17,"[[2, 1024, 8, 32], [256, 2, 64, 128], [4, 8, 512, 4], [0, 0, 4, 2]]",15008,left,0,"[[2, 1024, 8, 32], [256, 2, 64, 128], [4, 8, 512, 4], [4, 2, 0, 4]]",15008
17,"[[2, 1024, 8, 32], [256, 2, 64, 128], [4, 8, 512, 4], [4, 2, 0, 4]]",15008,up,16,"[[2, 1024, 8, 32], [256, 2, 64, 128], [8, 8, 512, 8], [4, 2, 0, 0]]",15024
17,"[[2, 1024, 8, 32], [256, 2, 64, 128], [8, 8, 512, 8], [4, 2, 0, 0]]",15024,left,16,"[[2, 1024, 8, 32], [256, 2, 64, 128], [16, 512, 8, 0], [4, 2, 0, 4]]",15040
17,"[[2, 1024, 8, 32], [256, 2, 64, 128], [16, 512, 8, 0], [4, 2, 0, 4]]",15040,up,0,"[[2, 1024, 8, 32], [256, 2, 64, 128], [16, 512, 8, 4], [4, 2, 0, 4]]",15040
17,"[[2, 1024, 8, 32], [256, 2, 64, 128], [16, 512, 8, 4], [4, 2, 0, 4]]",15040,down,8,"[[2, 1024, 0, 2], [256, 2, 8, 32], [16, 512, 64, 128], [4, 2, 8, 8]]",15048
17,"[[2, 1024, 0, 2], [256, 2, 8, 32], [16, 512, 64, 128], [4, 2, 8, 8]]",15048,right,16,"[[0, 2, 1024, 2], [256, 2, 8, 32], [16, 512, 64, 128], [2, 4, 2, 16]]",15064
17,"[[0, 2, 1024, 2], [256, 2, 8, 32], [16, 512, 64, 128], [2, 4, 2, 16]]",15064,up,4,"[[256, 4, 1024, 2], [16, 512, 8, 32], [2, 4, 64, 128], [0, 2, 2, 16]]",15068
17,"[[256, 4, 1024, 2], [16, 512, 8, 32], [2, 4, 64, 128], [0, 2, 2, 16]]",15068,right,4,"[[256, 4, 1024, 2], [16, 512, 8, 32], [2, 4, 64, 128], [4, 0, 4, 16]]",15072
17,"[[256, 4, 1024, 2], [16, 512, 8, 32], [2, 4, 64, 128], [4, 0, 4, 16]]",15072,right,8,"[[256, 4, 1024, 2], [16, 512, 8, 32], [2, 4, 64, 128], [0, 2, 8, 16]]",15080
17,"[[256, 4, 1024, 2], [16, 512, 8, 32], [2, 4, 64, 128], [0, 2, 8, 16]]",15080,down,0,"[[4, 4, 1024, 2], [256, 512, 8, 32], [16, 4, 64, 128], [2, 2, 8, 16]]",15080
17,"[[4, 4, 1024, 2], [256, 512, 8, 32], [16, 4, 64, 128], [2, 2, 8, 16]]",15080,right,12,"[[0, 8, 1024, 2], [256, 512, 8, 32], [16, 4, 64, 128], [4, 4, 8, 16]]",15092
17,"[[0, 8, 1024, 2], [256, 512, 8, 32], [16, 4, 64, 128], [4, 4, 8, 16]]",15092,down,8,"[[0, 4, 1024, 2], [256, 8, 8, 32], [16, 512, 64, 128], [4, 8, 8, 16]]",15100
17,"[[0, 4, 1024, 2], [256, 8, 8, 32], [16, 512, 64, 128], [4, 8, 8, 16]]",15100,up,0,"[[256, 4, 1024, 2], [16, 8, 8, 32], [4, 512, 64, 128], [2, 8, 8, 16]]",15100
17,"[[256, 4, 1024, 2], [16, 8, 8, 32], [4, 512, 64, 128], [2, 8, 8, 16]]",15100,right,32,"[[256, 4, 1024, 2], [0, 16, 16, 32], [4, 512, 64, 128], [4, 2, 16, 16]]",15132
17,"[[256, 4, 1024, 2], [0, 16, 16, 32], [4, 512, 64, 128], [4, 2, 16, 16]]",15132,right,64,"[[256, 4, 1024, 2], [0, 2, 32, 32], [4, 512, 64, 128], [0, 4, 2, 32]]",15196
17,"[[256, 4, 1024, 2], [0, 2, 32, 32], [4, 512, 64, 128], [0, 4, 2, 32]]",15196,left,64,"[[256, 4, 1024, 2], [2, 64, 0, 2], [4, 512, 64, 128], [4, 2, 32, 0]]",15260
17,"[[256, 4, 1024, 2], [2, 64, 0, 2], [4, 512, 64, 128], [4, 2, 32, 0]]",15260,up,12,"[[256, 4, 1024, 4], [2, 64, 64, 128], [8, 512, 32, 4], [0, 2, 0, 0]]",15272
17,"[[256, 4, 1024, 4], [2, 64, 64, 128], [8, 512, 32, 4], [0, 2, 0, 0]]",15272,right,128,"[[256, 4, 1024, 4], [2, 2, 128, 128], [8, 512, 32, 4], [0, 0, 0, 2]]",15400
17,"[[256, 4, 1024, 4], [2, 2, 128, 128], [8, 512, 32, 4], [0, 0, 0, 2]]",15400,left,260,"[[256, 4, 1024, 4], [4, 256, 0, 0], [8, 512, 32, 4], [2, 0, 2, 0]]",15660
17,"[[256, 4, 1024, 4], [4, 256, 0, 0], [8, 512, 32, 4], [2, 0, 2, 0]]",15660,right,4,"[[256, 4, 1024, 4], [4, 0, 4, 256], [8, 512, 32, 4], [0, 0, 0, 4]]",15664
17,"[[256, 4, 1024, 4], [4, 0, 4, 256], [8, 512, 32, 4], [0, 0, 0, 4]]",15664,left,8,"[[256, 4, 1024, 4], [8, 256, 0, 0], [8, 512, 32, 4], [4, 0, 4, 0]]",15672
17,"[[256, 4, 1024, 4], [8, 256, 0, 0], [8, 512, 32, 4], [4, 0, 4, 0]]",15672,down,24,"[[0, 0, 0, 0], [256, 4, 1024, 2], [16, 256, 32, 0], [4, 512, 4, 8]]",15696
17,"[[0, 0, 0, 0], [256, 4, 1024, 2], [16, 256, 32, 0], [4, 512, 4, 8]]",15696,down,0,"[[0, 0, 0, 4], [256, 4, 1024, 0], [16, 256, 32, 2], [4, 512, 4, 8]]",15696
17,"[[0, 0, 0, 4], [256, 4, 1024, 0], [16, 256, 32, 2], [4, 512, 4, 8]]",15696,right,0,"[[2, 0, 0, 4], [0, 256, 4, 1024], [16, 256, 32, 2], [4, 512, 4, 8]]",15696
17,"[[2, 0, 0, 4], [0, 256, 4, 1024], [16, 256, 32, 2], [4, 512, 4, 8]]",15696,down,512,"[[0, 0, 0, 4], [2, 4, 4, 1024], [16, 512, 32, 2], [4, 512, 4, 8]]",16208
17,"[[0, 0, 0, 4], [2, 4, 4, 1024], [16, 512, 32, 2], [4, 512, 4, 8]]",16208,up,1024,"[[2, 4, 4, 4], [16, 1024, 32, 1024], [4, 0, 4, 2], [0, 0, 4, 8]]",17232
17,"[[2, 4, 4, 4], [16, 1024, 32, 1024], [4, 0, 4, 2], [0, 0, 4, 8]]",17232,left,16,"[[2, 8, 4, 4], [16, 1024, 32, 1024], [8, 2, 0, 0], [4, 8, 0, 0]]",17248
17,"[[2, 8, 4, 4], [16, 1024, 32, 1024], [8, 2, 0, 0], [4, 8, 0, 0]]",17248,right,8,"[[4, 2, 8, 8], [16, 1024, 32, 1024], [0, 0, 8, 2], [0, 0, 4, 8]]",17256
17,"[[4, 2, 8, 8], [16, 1024, 32, 1024], [0, 0, 8, 2], [0, 0, 4, 8]]",17256,left,16,"[[4, 2, 16, 0], [16, 1024, 32, 1024], [8, 2, 0, 0], [4, 8, 2, 0]]",17272
17,"[[4, 2, 16, 0], [16, 1024, 32, 1024], [8, 2, 0, 0], [4, 8, 2, 0]]",17272,right,0,"[[0, 4, 2, 16], [16, 1024, 32, 1024], [0, 2, 8, 2], [0, 4, 8, 2]]",17272
17,"[[0, 4, 2, 16], [16, 1024, 32, 1024], [0, 2, 8, 2], [0, 4, 8, 2]]",17272,down,20,"[[0, 4, 4, 0], [0, 1024, 2, 16], [0, 2, 32, 1024], [16, 4, 16, 4]]",17292
17,"[[0, 4, 4, 0], [0, 1024, 2, 16], [0, 2, 32, 1024], [16, 4, 16, 4]]",17292,right,8,"[[0, 0, 0, 8], [2, 1024, 2, 16], [0, 2, 32, 1024], [16, 4, 16, 4]]",17300
17,"[[0, 0, 0, 8], [2, 1024, 2, 16], [0, 2, 32, 1024], [16, 4, 16, 4]]",17300,left,0,"[[8, 0, 4, 0], [2, 1024, 2, 16], [2, 32, 1024, 0], [16, 4, 16, 4]]",17300
17,"[[8, 0, 4, 0], [2, 1024, 2, 16], [2, 32, 1024, 0], [16, 4, 16, 4]]",17300,down,4,"[[0, 4, 4, 0], [8, 1024, 2, 0], [4, 32, 1024, 16], [16, 4, 16, 4]]",17304
17,"[[0, 4, 4, 0], [8, 1024, 2, 0], [4, 32, 1024, 16], [16, 4, 16, 4]]",17304,right,8,"[[0, 2, 0, 8], [0, 8, 1024, 2], [4, 32, 1024, 16], [16, 4, 16, 4]]",17312
17,"[[0, 2, 0, 8], [0, 8, 1024, 2], [4, 32, 1024, 16], [16, 4, 16, 4]]",17312,up,2048,"[[4, 2, 2048, 8], [16, 8, 16, 2], [0, 32, 0, 16], [2, 4, 0, 4]]",19360
